Genome,portal_link,DMAT,HYBRID,NRPS,NRPS-Like,PKS,PKS-Like,TC,Total
Aaosphaeria arxii CBS 175.79 v1.0,https://mycocosm.jgi.doe.gov/Aaoar1,2,0,7,7,16,4,5,41
Abortiporus biennis CCBS 521 v1.0,https://mycocosm.jgi.doe.gov/Abobi1,0,0,1,5,3,0,9,18
Abortiporus biennis CIRM-BRFM1778 v1.0,https://mycocosm.jgi.doe.gov/Abobie1,0,0,1,4,3,0,9,17
Absidia caerulea NRRL1315 v1.0,https://mycocosm.jgi.doe.gov/Abscae1,0,0,1,1,1,1,0,4
Absidia padenii NRRL 2977 v1.0,https://mycocosm.jgi.doe.gov/Chlpad1,0,0,1,1,1,1,0,4
Absidia repens NRRL 1336 v1.0,https://mycocosm.jgi.doe.gov/Absrep1,0,0,1,1,1,1,0,4
Acaromyces ingoldii MCA 4198 v1.0,https://mycocosm.jgi.doe.gov/Acain1,0,1,2,9,1,4,0,17
Acarospora strigata CBS 132363,https://mycocosm.jgi.doe.gov/Acastr1,2,2,5,4,18,3,0,34
Acephala macrosclerotiorum EW76-UTF0540 v1.0,https://mycocosm.jgi.doe.gov/Acema1,1,3,4,11,16,5,1,41
Achaetomium strumarium CBS333.67 v1.0,https://mycocosm.jgi.doe.gov/Achstr1,0,2,5,1,14,2,6,30
Acidomyces richmondensis BFW,https://mycocosm.jgi.doe.gov/Aciri1_iso,0,0,1,5,2,2,0,10
Acidomyces richmondensis BFW,https://mycocosm.jgi.doe.gov/Aciri1_meta,0,0,1,5,1,3,0,10
Acidothrix acidophila CBS 136259 v1.0,https://mycocosm.jgi.doe.gov/Aciaci1,1,2,2,8,4,2,2,21
Acremonium alcalophilum v2.0,https://mycocosm.jgi.doe.gov/Acral2,1,3,6,6,11,2,0,29
Acremonium chrysogenum ATCC 11550,https://mycocosm.jgi.doe.gov/Acrchr1,3,2,7,4,18,2,2,38
Acremonium strictum DS1bioAY4a v1.0,https://mycocosm.jgi.doe.gov/Acrst1,1,2,3,12,11,3,3,35
Agaricostilbum hyphaenes ATCC MYA-4628 v1.0,https://mycocosm.jgi.doe.gov/Agahy1,0,0,0,2,1,0,0,3
Agaricus bisporus var bisporus (H97) v2.0,https://mycocosm.jgi.doe.gov/Agabi_varbisH97_2,2,0,0,7,2,0,6,17
Agaricus bisporus var. burnettii JB137-S8,https://mycocosm.jgi.doe.gov/Agabi_varbur_1,2,0,0,7,2,0,6,17
Agrocybe pediades AH 40210 v1.0,https://mycocosm.jgi.doe.gov/Agrped1,1,2,1,15,5,0,11,35
Agrocybe praecox OKM6292 v1.0,https://mycocosm.jgi.doe.gov/Agrpra2,2,1,1,12,3,0,10,29
Albatrellus peckianus DAOM 52321 v1.0,https://mycocosm.jgi.doe.gov/Albpec1,2,0,0,20,5,0,4,31
Aliquandostipite khaoyaiensis CBS 118232 v1.0,https://mycocosm.jgi.doe.gov/Alikh1,0,2,5,1,7,2,0,17
Allomyces macrogynus ATCC 38327,https://mycocosm.jgi.doe.gov/Allma1,0,0,0,2,2,2,0,6
Alternaria alternata ATCC11680,https://mycocosm.jgi.doe.gov/Alalt1,0,1,5,7,9,2,3,27
Alternaria alternata ATCC66891,https://mycocosm.jgi.doe.gov/Alalte1,0,1,4,7,8,3,3,26
Alternaria alternata BMP0270,https://mycocosm.jgi.doe.gov/Aalte1,0,0,4,7,9,3,3,26
Alternaria alternata MPI-PUGE-AT-0064 v1.0,https://mycocosm.jgi.doe.gov/Altalt1,0,1,4,7,7,3,3,25
Alternaria alternata SRC1lrK2f v1.0,https://mycocosm.jgi.doe.gov/Altal1,1,1,5,7,9,3,3,29
Alternaria arborescens BMP0308,https://mycocosm.jgi.doe.gov/Altar1,1,0,9,6,10,3,1,30
Alternaria brassicicola,https://mycocosm.jgi.doe.gov/Altbr1,0,0,4,6,6,3,5,24
Alternaria brassicicola ATCC96836,https://mycocosm.jgi.doe.gov/Albra1,0,0,4,6,6,3,5,24
Alternaria capsici BMP0180,https://mycocosm.jgi.doe.gov/Altca1,2,1,6,6,8,3,2,28
Alternaria carthami BMP1963,https://mycocosm.jgi.doe.gov/Altcar1,2,1,10,8,14,2,2,39
Alternaria citriarbusti BMP2343,https://mycocosm.jgi.doe.gov/Altci1,0,1,7,8,11,2,3,32
Alternaria crassa BMP0172,https://mycocosm.jgi.doe.gov/Altcr1,2,1,5,6,12,3,3,32
Alternaria dauci BMP0167,https://mycocosm.jgi.doe.gov/Altda1,1,1,6,6,13,2,3,32
Alternaria fragaria BMP3062,https://mycocosm.jgi.doe.gov/Altfr1,2,1,4,7,9,3,3,29
Alternaria gaisen BMP2338,https://mycocosm.jgi.doe.gov/Altga1,0,0,8,7,10,1,3,29
Alternaria limoniasperae BMP2335,https://mycocosm.jgi.doe.gov/Altli1,1,1,5,7,12,2,2,30
Alternaria longipes BMP0313,https://mycocosm.jgi.doe.gov/Altlo1,0,0,8,8,6,3,3,28
Alternaria macrospora BMP1949,https://mycocosm.jgi.doe.gov/Altma1,1,2,5,9,12,3,4,36
Alternaria mali BMP3063,https://mycocosm.jgi.doe.gov/Amal3063,0,1,4,7,9,3,3,27
Alternaria mali BMP3064,https://mycocosm.jgi.doe.gov/Amal3064,1,1,7,8,8,1,2,28
Alternaria porri BMP0178,https://mycocosm.jgi.doe.gov/Altpo1,1,1,11,7,9,2,3,34
Alternaria rosae MPI-PUGE-AT-0040 v1.0,https://mycocosm.jgi.doe.gov/Altro1,1,1,4,6,12,2,1,27
Alternaria solani BMP0185,https://mycocosm.jgi.doe.gov/Altso1,2,0,8,6,14,1,2,33
Alternaria sp. UNIPAMPA012 v1.0,https://mycocosm.jgi.doe.gov/Altsp012_1,0,1,6,5,8,2,2,24
Alternaria sp. UNIPAMPA017 v1.0,https://mycocosm.jgi.doe.gov/Altsp017_1,1,1,3,5,9,3,1,23
Alternaria tangelonis BMP2327,https://mycocosm.jgi.doe.gov/Altta1,1,1,5,8,10,3,3,31
Alternaria tenuissima BMP0304,https://mycocosm.jgi.doe.gov/Altte1,1,1,5,7,9,3,3,29
Alternaria tomatophila BMP2032,https://mycocosm.jgi.doe.gov/Alttom1,2,0,9,8,14,4,2,39
Amanita muscaria Koide v1.0,https://mycocosm.jgi.doe.gov/Amamu1,1,0,0,2,3,0,10,16
Amanita muscaria var. formosa 2016PMI152 v1.0,https://mycocosm.jgi.doe.gov/Amaapr1,1,0,0,2,2,0,8,13
Amanita rubescens Přilba v1.0,https://mycocosm.jgi.doe.gov/Amarub1,1,0,0,2,3,0,5,11
Amanita thiersii Skay4041 v1.0,https://mycocosm.jgi.doe.gov/Amath1,1,0,0,3,2,1,5,12
Ambrosiozyma philentoma NRRL Y-7523,https://mycocosm.jgi.doe.gov/Ambph1,0,0,0,1,0,2,0,3
Amniculicola lignicola CBS 123094 v1.0,https://mycocosm.jgi.doe.gov/Amnli1,1,4,4,5,17,3,2,36
Amorphotheca resinae v1.0,https://mycocosm.jgi.doe.gov/Amore1,0,0,3,4,5,3,1,16
Ampelomyces quisqualis HMLAC05119 v1.0,https://mycocosm.jgi.doe.gov/Ampqui1,1,1,5,5,7,2,2,23
Amphiamblys sp. WSBS2006,https://mycocosm.jgi.doe.gov/AmpWSBS2006_1,,,,,,,,0
Amylocarpus encephaloides TRa018bII v1.0,https://mycocosm.jgi.doe.gov/Amyenc1,0,1,6,5,15,3,1,31
Amylocorticium subincarnatum OMC1654 v1.0,https://mycocosm.jgi.doe.gov/Amysub1,0,0,0,6,2,1,15,24
Amylocystis lapponica SKaAmylap13 v1.0,https://mycocosm.jgi.doe.gov/Amylap1_1,0,1,0,11,3,0,9,24
Amylomyces rouxii NRRL 5866 v1.0,https://mycocosm.jgi.doe.gov/Amyrou1,0,0,1,7,2,1,0,11
Amylostereum chailletii DWAch2 v1.0,https://mycocosm.jgi.doe.gov/Amycha1,0,0,1,11,2,2,5,21
Anaeromyces robustus v1.0,https://mycocosm.jgi.doe.gov/Anasp1,0,0,28,3,6,8,0,45
Annulohypoxylon bovei var. microspora CBS 124037 v1.0,https://mycocosm.jgi.doe.gov/Annbov1,2,1,5,14,23,4,8,57
Annulohypoxylon maeteangense CBS 123835 v1.0,https://mycocosm.jgi.doe.gov/Annmae1,2,2,9,8,30,3,9,63
Annulohypoxylon minutellum CBS 135445 v1.0,https://mycocosm.jgi.doe.gov/Annmin1,3,1,6,10,33,3,8,64
Annulohypoxylon moriforme CBS 123579 v1.0,https://mycocosm.jgi.doe.gov/Annmor1,2,2,8,9,31,3,6,61
Annulohypoxylon nitens CBS 120705 v1.0,https://mycocosm.jgi.doe.gov/Annnit1,1,1,6,12,36,3,9,68
Annulohypoxylon sp. FL0455 v1.0,https://mycocosm.jgi.doe.gov/AnFL0455,3,2,5,9,28,3,8,58
Annulohypoxylon stygium FL0470 v1.0,https://mycocosm.jgi.doe.gov/Annsty1,1,2,7,12,31,3,8,64
Annulohypoxylon truncatum CBS 140777 v1.0,https://mycocosm.jgi.doe.gov/Anntru1,3,2,4,14,25,4,9,61
Anomoloma albolutescens OMC1655 v1.0,https://mycocosm.jgi.doe.gov/Anoalb1,2,0,1,6,2,0,4,15
Anomoporia bombycina ATCC 64506 v1.0,https://mycocosm.jgi.doe.gov/Anobom1,1,1,0,9,5,1,19,36
Anomoporia kamtschatica OMC1758 v1.0,https://mycocosm.jgi.doe.gov/Anokam1,1,0,5,13,5,0,19,43
Anomoporia myceliosa MJL 4413 v1.0,https://mycocosm.jgi.doe.gov/Anomyc1,0,0,1,7,3,4,6,21
Anthostoma avocetta NRRL 3190 v1.0,https://mycocosm.jgi.doe.gov/Antav1,9,7,14,17,48,6,17,118
Anthostomella leucospermi CBS110126 v1.0,https://mycocosm.jgi.doe.gov/Antleu1,4,5,14,16,35,6,12,92
Anthostomella tomicoides 1013 v1.0,https://mycocosm.jgi.doe.gov/Anttom1,6,8,18,17,45,6,13,113
Antonospora locustae HM-2013,https://mycocosm.jgi.doe.gov/Antlo1,,,,,,,,0
Antrodia serialis Sig1Antser10 v1.0,https://mycocosm.jgi.doe.gov/Antser1,1,0,0,11,11,1,15,39
Antrodia sinuosa LB1 v1.0,https://mycocosm.jgi.doe.gov/Antsi1,1,0,0,9,4,0,11,25
Antrodiella citrinella FBCC 969 v1.0,https://mycocosm.jgi.doe.gov/Antcit1,0,0,0,17,3,0,7,27
Aphanobasidium pseudotsugae OMC1630 v1.0,https://mycocosm.jgi.doe.gov/Aphpse1,6,1,0,7,1,0,7,22
Apiosordaria backusii CBS 540.89 v1.0,https://mycocosm.jgi.doe.gov/Apibac1,3,1,5,6,10,2,2,29
Apiospora montagnei NRRL 25634 v1.0,https://mycocosm.jgi.doe.gov/Apimo1,2,6,11,10,36,4,7,76
Aplosporella prunicola CBS 121.167 v1.0,https://mycocosm.jgi.doe.gov/Aplpr1,1,4,6,8,10,2,3,34
Apodospora peruviana CBS 118394 v1.0,https://mycocosm.jgi.doe.gov/Apope1,1,3,12,5,16,3,5,45
Aporpium caryae L-13461,https://mycocosm.jgi.doe.gov/Elmca1,2,0,1,7,3,0,5,18
Armillaria borealis FPL87.14 v1.0,https://mycocosm.jgi.doe.gov/Armbor1,0,1,1,18,9,0,13,42
Armillaria cepistipes B5,https://mycocosm.jgi.doe.gov/Armcep1,0,2,1,21,4,0,22,50
Armillaria ectypa FPL83.16 v1.0,https://mycocosm.jgi.doe.gov/Armect1,0,2,1,10,5,0,9,27
Armillaria fumosa CBS 122221 v1.0,https://mycocosm.jgi.doe.gov/Armfum1,0,2,1,16,3,0,11,33
Armillaria gallica 21-2 v1.0,https://mycocosm.jgi.doe.gov/Armga1,0,2,1,21,6,0,17,47
Armillaria luteobubalina HWK02 v1.0,https://mycocosm.jgi.doe.gov/Armlut1,0,3,1,13,8,0,15,40
Armillaria mellea DSM 3731,https://mycocosm.jgi.doe.gov/Armme1_1,0,0,1,15,5,0,9,30
Armillaria mellea ELDO17 v1.0,https://mycocosm.jgi.doe.gov/Armmel1,0,2,1,14,6,0,9,32
Armillaria nabsnona CMW6904 v1.0,https://mycocosm.jgi.doe.gov/Armnab1,0,2,1,15,4,1,14,37
Armillaria novae-zelandiae 2840 v1.0,https://mycocosm.jgi.doe.gov/Armnov1,0,1,1,19,4,1,10,36
Armillaria ostoyae C18/9,https://mycocosm.jgi.doe.gov/Armosto1,0,2,1,19,5,0,15,42
Armillaria solidipes 28-4 v1.0,https://mycocosm.jgi.doe.gov/Armost1,0,2,2,19,5,0,15,43
Armillaria tabescens CCBAS 213 v1.0,https://mycocosm.jgi.doe.gov/Armtab1,0,2,2,14,5,0,12,35
Arthroascus fermentans 17710 v1.0,https://mycocosm.jgi.doe.gov/Artfe1_2,0,0,0,1,0,2,0,3
Arthrobotrys oligospora ATCC 24927,https://mycocosm.jgi.doe.gov/Artol1,1,0,1,4,4,2,4,16
Arthroderma benhamiae CBS 112371,https://mycocosm.jgi.doe.gov/Artbe1,2,3,14,4,7,2,2,34
Artolenzites elegans CIRM-BRFM 1122 v1.0,https://mycocosm.jgi.doe.gov/Artele1122_1,0,0,1,9,5,0,8,23
Artolenzites elegans CIRM-BRFM 1663 v1.0,https://mycocosm.jgi.doe.gov/Artel1,,,,,,,,0
Ascobolus immersus RN42 v1.0,https://mycocosm.jgi.doe.gov/Ascim1,1,0,2,1,2,2,0,8
Ascochyta rabiei ArDII,https://mycocosm.jgi.doe.gov/Ascra1,1,1,2,7,8,2,0,21
Ascocoryne sarcoides NRRL50072,https://mycocosm.jgi.doe.gov/Ascsa1,1,1,3,7,2,2,1,17
Ascodesmis nigricans CBS 389.68 v1.0,https://mycocosm.jgi.doe.gov/Ascni1,0,0,2,3,0,2,0,7
Ascoidea rubescens NRRL Y17699 v1.0,https://mycocosm.jgi.doe.gov/Ascru1,0,0,0,1,0,2,0,3
Ascosphaera apis ARSEF 7405,https://mycocosm.jgi.doe.gov/Ascap1,0,0,2,5,1,2,0,10
Aspergillus acristatulus CBS 119.55 v1.0,https://mycocosm.jgi.doe.gov/Aspacri1,3,2,12,14,31,3,0,65
Aspergillus aculeatinus CBS 121060 v1.0,https://mycocosm.jgi.doe.gov/Aspacu1,6,2,19,20,28,3,3,81
Aspergillus aculeatus ATCC16872 v1.1,https://mycocosm.jgi.doe.gov/Aspac1,3,4,18,21,19,4,2,71
Aspergillus affinis CBS 129190 v1.0,https://mycocosm.jgi.doe.gov/Aspaff1,13,8,13,22,36,3,6,101
Aspergillus alabamensis v1.0,https://mycocosm.jgi.doe.gov/Aspala1,7,4,14,16,21,3,3,68
Aspergillus albertensis v1.0,https://mycocosm.jgi.doe.gov/Aspalbe1,5,2,13,17,38,7,4,86
Aspergillus allahabadii v1.0,https://mycocosm.jgi.doe.gov/Aspall1,10,3,10,19,16,2,1,61
Aspergillus alliaceus CBS 536.65 v1.0,https://mycocosm.jgi.doe.gov/Aspalli1,2,2,15,20,37,8,5,89
Aspergillus ambiguus v1.0,https://mycocosm.jgi.doe.gov/Aspamb1,8,1,11,18,18,1,2,59
Aspergillus amoeneus CBS 111.32 v1.0,https://mycocosm.jgi.doe.gov/Aspamoe1,10,3,14,12,19,4,0,62
Aspergillus amylovorus CBS 600.67 v1.0,https://mycocosm.jgi.doe.gov/Aspamy1,2,3,11,9,27,2,6,60
Aspergillus arachidicola v1.0,https://mycocosm.jgi.doe.gov/Aspara19utr,10,3,18,13,18,5,3,70
Aspergillus arxii CBS 52583 v1.0,https://mycocosm.jgi.doe.gov/Asparx1,1,1,4,10,11,2,0,29
Aspergillus assulatus CBS 27911 v1.0,https://mycocosm.jgi.doe.gov/Aspass1,2,1,4,7,9,2,4,29
Aspergillus astellatus v1.0,https://mycocosm.jgi.doe.gov/Aspaste1,3,6,12,15,29,6,5,76
Aspergillus aurantiobrunneus CBS 465.65 v1.0,https://mycocosm.jgi.doe.gov/Aspaura1,6,1,10,14,20,3,6,60
Aspergillus aureofulgens IBT 27100 v1.0,https://mycocosm.jgi.doe.gov/Aspaurful1,11,0,12,18,13,2,1,57
Aspergillus aureolatus CBS 190.65 v1.0,https://mycocosm.jgi.doe.gov/Aspaurlat1,7,3,15,6,36,5,3,75
Aspergillus aureoluteus CBS 105.55 v1.0,https://mycocosm.jgi.doe.gov/Aspaurlut1,5,2,6,8,9,3,3,36
Aspergillus aureoterreus v1.0,https://mycocosm.jgi.doe.gov/Aspaur1,8,2,14,14,17,3,6,64
Aspergillus avenaceus IBT 18842 v1.0,https://mycocosm.jgi.doe.gov/Aspave1,1,4,11,18,18,4,6,62
Aspergillus bertholletius IBT 29228 v1.0,https://mycocosm.jgi.doe.gov/Aspber1,6,5,11,10,22,5,6,65
Aspergillus biplanus CBS 468.65 v1.0,https://mycocosm.jgi.doe.gov/Aspbip1,5,1,11,19,34,6,7,83
Aspergillus bisporus CBS 707.71 v1.0,https://mycocosm.jgi.doe.gov/Aspbisp1,2,1,8,12,12,4,2,41
Aspergillus bombycis NRRL 26010,https://mycocosm.jgi.doe.gov/Aspbom1,7,4,18,18,22,9,5,83
Aspergillus botucatensis CBS 114221 v1.0,https://mycocosm.jgi.doe.gov/Aspbot1,10,2,14,8,16,4,1,55
Aspergillus brasiliensis v1.0,https://mycocosm.jgi.doe.gov/Aspbr1,2,5,11,17,29,6,3,73
Aspergillus brevijanus CBS 111.46 v1.0,https://mycocosm.jgi.doe.gov/Aspbrev1,10,3,20,23,39,3,4,102
Aspergillus brevipes CBS 118.53 v1.0,https://mycocosm.jgi.doe.gov/Aspbre1,4,3,8,18,19,3,2,57
Aspergillus brunneoviolaceus CBS 621.78 v1.0,https://mycocosm.jgi.doe.gov/Aspbru1,4,2,21,21,24,3,4,79
Aspergillus caelatus CBS 763.97 v1.0,https://mycocosm.jgi.doe.gov/Aspcae1,8,4,16,20,22,8,5,83
Aspergillus calidoustus,https://mycocosm.jgi.doe.gov/Aspcal1,7,1,9,13,28,2,6,66
Aspergillus californicus CBS 123895 v1.0,https://mycocosm.jgi.doe.gov/Aspcalif1,8,5,19,16,29,4,6,87
Aspergillus campestris IBT 28561 v1.0,https://mycocosm.jgi.doe.gov/Aspcam1,5,5,11,11,12,2,2,48
Aspergillus candidus CBS 102.13 v1.0,https://mycocosm.jgi.doe.gov/Aspcand1,4,4,11,6,16,3,1,45
Aspergillus caninus CBS 128032 v1.0,https://mycocosm.jgi.doe.gov/Aspcanin1,0,0,3,3,9,2,0,17
Aspergillus capensis CBS 138188 v1.0,https://mycocosm.jgi.doe.gov/Aspcap1,6,3,20,18,13,3,5,68
Aspergillus carbonarius ITEM 5010 v3,https://mycocosm.jgi.doe.gov/Aspca3,2,5,11,20,18,4,4,64
Aspergillus carlsbadensis CBS 123894 v1.0,https://mycocosm.jgi.doe.gov/Aspcar1,5,2,9,16,26,3,7,68
Aspergillus cervinus CBS 196.64 v1.0,https://mycocosm.jgi.doe.gov/Aspcer1,3,1,16,10,24,5,4,63
Aspergillus chevalieri CBS 522.65 v1.0,https://mycocosm.jgi.doe.gov/Aspchev1,2,1,3,10,13,2,0,31
Aspergillus chrysellus CBS 472.65 v1.0,https://mycocosm.jgi.doe.gov/Aspchr1,7,11,14,26,38,5,4,105
Aspergillus clavatonanicus v1.0,https://mycocosm.jgi.doe.gov/Aspcla1,4,4,11,7,15,3,3,47
Aspergillus clavatus NRRL 1 from AspGD,https://mycocosm.jgi.doe.gov/Aspcl1,3,4,10,5,16,3,4,45
Aspergillus cleistominutus CBS 200.75 v1.0,https://mycocosm.jgi.doe.gov/Aspcle1,6,2,15,14,27,2,3,69
Aspergillus coreanus CBS 117059 v1.0,https://mycocosm.jgi.doe.gov/Aspcorea1,8,1,11,10,14,2,1,47
Aspergillus coremiiformis CBS 553.77 v1.0,https://mycocosm.jgi.doe.gov/Aspcor1,5,0,6,8,15,2,2,38
Aspergillus costaricaensis CBS 115574 v1.0,https://mycocosm.jgi.doe.gov/Aspcos1,3,5,17,21,32,7,7,92
Aspergillus costiformis CBS 101749 v1.0,https://mycocosm.jgi.doe.gov/Aspcost1,2,0,5,10,11,2,0,30
Aspergillus creber IBT 32277 v1.0,https://mycocosm.jgi.doe.gov/Aspcreb1,9,4,17,11,21,4,1,67
Aspergillus cretensis CBS 112802 v1.0,https://mycocosm.jgi.doe.gov/Aspcre1,12,10,14,21,31,6,4,98
Aspergillus cristatus GZAAS20.1005,https://mycocosm.jgi.doe.gov/Aspcri1,1,0,5,13,11,2,1,33
Aspergillus crustosus CBS 478.65 v1.0,https://mycocosm.jgi.doe.gov/Aspcru1,7,0,7,11,18,3,3,49
Aspergillus cumulatus DTO 311-F5 v1.0,https://mycocosm.jgi.doe.gov/Aspcu1,2,0,4,9,9,4,0,28
Aspergillus dentatus CBS 114.63 v1.0,https://mycocosm.jgi.doe.gov/Aspden1,6,2,10,16,24,5,1,64
Aspergillus desertorum CBS 653.73 v1.0,https://mycocosm.jgi.doe.gov/Aspdese1,4,3,7,12,20,9,5,60
Aspergillus dromiae CBS 140633 v1.0,https://mycocosm.jgi.doe.gov/Aspdro1,5,2,8,14,35,3,6,73
Aspergillus duricaulis CBS 481.65 v1.0,https://mycocosm.jgi.doe.gov/Aspdur1,7,2,4,10,24,2,4,53
Aspergillus egyptiacus CBS 656.73 v1.0,https://mycocosm.jgi.doe.gov/Aspegy1,4,0,16,8,19,4,4,55
Aspergillus elegans CBS 116.39 v1.0,https://mycocosm.jgi.doe.gov/Aspele1,8,8,17,26,27,3,5,94
Aspergillus ellipticus CBS 707.79 v1.0,https://mycocosm.jgi.doe.gov/Aspell1,2,2,15,14,28,7,4,72
Aspergillus eucalypticola CBS 122712 v1.0,https://mycocosm.jgi.doe.gov/Aspeuc1,2,6,11,19,26,4,6,74
Aspergillus falconensis CBS 271.91 v1.0,https://mycocosm.jgi.doe.gov/Aspfalc1,5,2,12,13,33,5,2,72
Aspergillus ferenczii CBS 121594 v1.0,https://mycocosm.jgi.doe.gov/Aspfer1,2,2,7,9,12,2,3,37
Aspergillus fijiensis CBS 313.89 v1.0,https://mycocosm.jgi.doe.gov/Aspfij1,5,3,21,25,26,3,4,87
Aspergillus filifera CBS 114510 v1.0,https://mycocosm.jgi.doe.gov/Aspfili1,5,1,10,13,30,3,3,65
Aspergillus flavipes CBS 22552 v1.0,https://mycocosm.jgi.doe.gov/Aspfla1,7,3,19,26,28,6,3,92
Aspergillus flavus NRRL3357,https://mycocosm.jgi.doe.gov/Aspfl1,10,1,16,16,20,7,3,73
Aspergillus flavus NRRL3357 v1.0,https://mycocosm.jgi.doe.gov/Aspfl2_3,9,1,16,17,24,6,4,77
Aspergillus floccosus CBS 116.37 v1.0,https://mycocosm.jgi.doe.gov/Aspflo1,10,5,19,23,26,3,3,89
Aspergillus flocculosus v1.0,https://mycocosm.jgi.doe.gov/Aspfloc1,8,5,18,24,28,2,4,89
Aspergillus floridensis DTO 198-A8 v1.0,https://mycocosm.jgi.doe.gov/Aspflor1,4,1,16,21,23,4,3,72
Aspergillus foveolata CBS 279.81 v1.0,https://mycocosm.jgi.doe.gov/Aspfove1,5,2,8,17,29,4,3,68
Aspergillus frequens CBS 586.65 v1.0,https://mycocosm.jgi.doe.gov/Aspfre1,8,2,13,24,16,2,4,69
Aspergillus fructiculosus v1.0,https://mycocosm.jgi.doe.gov/Aspfru1,5,2,10,14,38,2,2,73
Aspergillus fumigatiaffinis CBS 117186 v1.0,https://mycocosm.jgi.doe.gov/Aspfumig1,7,2,19,12,23,3,3,69
Aspergillus fumigatus A1163,https://mycocosm.jgi.doe.gov/Aspfu_A1163_1,3,2,8,6,11,2,0,32
Aspergillus fumigatus Af293 from AspGD,https://mycocosm.jgi.doe.gov/Aspfu1,2,0,9,7,14,2,0,34
Aspergillus fumisynnematus IBT 28474 v1.0,https://mycocosm.jgi.doe.gov/Aspfumis1,8,2,13,10,20,4,2,59
Aspergillus funiculosus CBS 116.56 v1.0,https://mycocosm.jgi.doe.gov/Aspfuni1,5,0,5,5,15,2,3,35
Aspergillus galapagensis CBS 117522 v1.0,https://mycocosm.jgi.doe.gov/Aspgal1,3,2,9,9,12,2,2,39
Aspergillus germanicus CBS 123887 v1.0,https://mycocosm.jgi.doe.gov/Aspger1,5,0,10,16,24,3,7,65
Aspergillus giganteus CBS 515.65 v1.0,https://mycocosm.jgi.doe.gov/Aspgig1,3,3,12,7,18,3,2,48
Aspergillus glaucus v1.0,https://mycocosm.jgi.doe.gov/Aspgl1,1,0,6,11,13,3,0,34
Aspergillus granulosus CBS 588.65 v1.0,https://mycocosm.jgi.doe.gov/Aspgra1,8,0,8,13,22,2,5,58
Aspergillus haitiensis CBS 468.91 v1.0,https://mycocosm.jgi.doe.gov/Asphai1,3,0,6,10,29,3,8,59
Aspergillus heteromorphus CBS 117.55 v1.0,https://mycocosm.jgi.doe.gov/Asphet1,4,3,12,16,16,3,3,57
Aspergillus heterothallicus CBS 489.65 v1.0,https://mycocosm.jgi.doe.gov/Asphethal1,4,0,9,16,15,4,4,52
Aspergillus hiratsukae CBS 294.93 v1.0,https://mycocosm.jgi.doe.gov/Asphir1,4,2,10,9,10,3,2,40
Aspergillus homomorphus CBS 101889 v1.0,https://mycocosm.jgi.doe.gov/Asphom1,4,3,16,22,24,5,4,78
Aspergillus ibericus CBS 121593 v1.0,https://mycocosm.jgi.doe.gov/Aspibe1,2,6,7,18,15,6,3,57
Aspergillus igneus CBS 466.65 v1.0,https://mycocosm.jgi.doe.gov/Aspign1,5,4,13,10,23,2,1,58
Aspergillus iizukae CBS 541.69 v1.0,https://mycocosm.jgi.doe.gov/Aspiiz1,7,4,18,22,16,3,3,73
Aspergillus implicatus CBS 484.95 v1.0,https://mycocosm.jgi.doe.gov/Aspimp1,3,4,13,18,49,5,8,100
Aspergillus indicus v2.0,https://mycocosm.jgi.doe.gov/Aspind2_1,7,2,10,14,29,2,2,66
Aspergillus indologenus CBS 114.80 v1.0,https://mycocosm.jgi.doe.gov/Aspind1,6,5,17,24,27,3,2,84
Aspergillus insolitus CBS 384.61 v1.0,https://mycocosm.jgi.doe.gov/Aspinso1,0,1,9,7,9,2,1,29
Aspergillus insuetus CBS 107.25 v1.0,https://mycocosm.jgi.doe.gov/Aspins1,5,1,8,17,27,2,6,66
Aspergillus japonicus CBS 114.51 v1.0,https://mycocosm.jgi.doe.gov/Aspjap1,4,1,21,22,19,3,1,71
Aspergillus karnatakaensis CBS 102800 v1.0,https://mycocosm.jgi.doe.gov/Aspkar1,11,3,12,19,29,5,2,81
Aspergillus kawachii IFO 4308,https://mycocosm.jgi.doe.gov/Aspka1_1,2,6,15,17,33,5,6,84
Aspergillus keveii CBS 209.92 v1.0,https://mycocosm.jgi.doe.gov/Aspkev1,8,0,11,17,25,3,8,72
Aspergillus laciniosus CBS 117721 v1.0,https://mycocosm.jgi.doe.gov/Asplaci1,9,2,16,11,15,5,1,59
Aspergillus lentulus CBS 117885 v1.0,https://mycocosm.jgi.doe.gov/Asplen1,6,2,12,9,18,3,2,52
Aspergillus leporis CBS 151.66 v1.0,https://mycocosm.jgi.doe.gov/Asplep1,8,6,17,23,25,4,3,86
Aspergillus longivesica v1.0,https://mycocosm.jgi.doe.gov/Asplon1,3,4,12,8,10,5,2,44
Aspergillus luchuensis CBS 106.47 v1.0,https://mycocosm.jgi.doe.gov/Aspfo1,2,6,16,22,30,5,6,87
Aspergillus lucknowensis CBS 449.75 v1.0,https://mycocosm.jgi.doe.gov/Aspluc1,3,3,7,6,23,5,3,50
Aspergillus luppii CBS 653.74 v1.0,https://mycocosm.jgi.doe.gov/Asplup1,10,0,14,19,12,3,1,59
Aspergillus microcysticus CBS 120.58 v1.0,https://mycocosm.jgi.doe.gov/Aspmic1,0,2,8,14,13,2,1,40
Aspergillus minisclerotigenes CBS 117635 v1.0,https://mycocosm.jgi.doe.gov/Aspmin1,11,1,16,18,26,7,4,83
Aspergillus miraensis CBS 140625 v1.0,https://mycocosm.jgi.doe.gov/Aspmir1,5,3,7,13,34,4,4,70
Aspergillus multicolor v1.0,https://mycocosm.jgi.doe.gov/Aspmul1_1,4,3,10,17,28,5,2,69
Aspergillus multiplicatus CBS 646958 v1.0,https://mycocosm.jgi.doe.gov/Aspmult1,2,1,4,8,6,3,3,27
Aspergillus muricatus v1.0,https://mycocosm.jgi.doe.gov/Aspmuri1,8,3,14,22,29,3,4,83
Aspergillus nakazawae v1.0,https://mycocosm.jgi.doe.gov/Aspnaka1,9,3,10,25,33,3,7,90
Aspergillus navahoensis v1.0,https://mycocosm.jgi.doe.gov/Aspnav1_1,4,2,11,17,33,5,2,74
Aspergillus neoauricomus CBS112787 v1.0,https://mycocosm.jgi.doe.gov/Aspneoa1,6,5,10,23,33,3,4,84
Aspergillus neoconicus CBS 233.90 v1.0,https://mycocosm.jgi.doe.gov/Aspneoc1,1,0,7,8,8,3,0,27
Aspergillus neoechinulatus CBS120.55 v1.0,https://mycocosm.jgi.doe.gov/Aspne1,4,0,9,11,28,3,2,57
Aspergillus neoflavipes CBS 260.73 v1.0,https://mycocosm.jgi.doe.gov/Aspneof1,9,3,19,25,18,2,3,79
Aspergillus neoindicus CBS 444.75 v1.0,https://mycocosm.jgi.doe.gov/Aspneoi1,8,2,17,19,20,3,2,71
Aspergillus neoniger CBS 115656 v1.0,https://mycocosm.jgi.doe.gov/Aspneo1,3,4,13,16,29,6,9,80
Aspergillus neowarcupii IBT 29024 v1.0,https://mycocosm.jgi.doe.gov/Aspneow1,3,1,10,13,21,2,3,53
Aspergillus nidulans,https://mycocosm.jgi.doe.gov/Aspnid1,5,1,9,13,22,5,1,56
Aspergillus niger (lacticoffeatus) CBS 101883 v1.0,https://mycocosm.jgi.doe.gov/Asplac1,2,9,16,16,23,6,7,79
Aspergillus niger (phoenicis Corda) Thom ATCC 13157 v1.0,https://mycocosm.jgi.doe.gov/Aspph1,2,9,15,18,26,5,6,81
Aspergillus niger ATCC 1015 v4.0,https://mycocosm.jgi.doe.gov/Aspni7,2,9,16,16,27,4,6,80
Aspergillus niger CBS 513.88,https://mycocosm.jgi.doe.gov/Aspni_DSM_1,2,6,14,15,29,5,6,77
Aspergillus niger NRRL3,https://mycocosm.jgi.doe.gov/Aspni_NRRL3_1,2,9,16,16,29,4,6,82
Aspergillus niger van Tieghem ATCC 13496 v1.0,https://mycocosm.jgi.doe.gov/Aspni_bvT_1,2,8,15,14,29,4,7,79
Aspergillus nishimurae IFM 54133 v1.0,https://mycocosm.jgi.doe.gov/Aspnis1,2,1,2,9,6,3,3,26
Aspergillus nomius IBT 12657 v1.0,https://mycocosm.jgi.doe.gov/Aspnom1,7,1,16,18,24,6,3,75
Aspergillus nomius NRRL 13137,https://mycocosm.jgi.doe.gov/Aspnom13137_1,5,3,19,19,26,5,4,81
Aspergillus novofumigatus IBT 16806 v1.0,https://mycocosm.jgi.doe.gov/Aspnov1,4,3,16,5,24,2,2,56
Aspergillus novoparasiticus CBS 126849 v1.0,https://mycocosm.jgi.doe.gov/Aspnovo1,8,1,16,18,25,6,3,77
Aspergillus nutans CBS 121.56 v1.0,https://mycocosm.jgi.doe.gov/Aspnut1,3,2,27,15,15,4,2,68
Aspergillus ochraceoroseus IBT 24754 v1.0,https://mycocosm.jgi.doe.gov/Aspoch1,4,2,6,3,10,2,1,28
Aspergillus ochraceoroseus SRRC1432,https://mycocosm.jgi.doe.gov/Aspoch1432_1,4,1,6,4,9,3,1,28
Aspergillus oerlinghausenensis CBS 139183 v1.0,https://mycocosm.jgi.doe.gov/Aspoer1,7,0,10,7,12,2,0,38
Aspergillus olivicola v1.0,https://mycocosm.jgi.doe.gov/Aspoli1_1,5,2,7,12,29,4,3,62
Aspergillus oryzae RIB40,https://mycocosm.jgi.doe.gov/Aspor1,9,2,14,15,23,5,2,70
Aspergillus ostianus v1.0,https://mycocosm.jgi.doe.gov/Asposti1,8,4,12,17,34,4,4,83
Aspergillus paleaceus CBS 498.65 v1.0,https://mycocosm.jgi.doe.gov/Asppal1_1,2,0,7,7,8,3,1,28
Aspergillus papuensis CBS 841.96 v1.0,https://mycocosm.jgi.doe.gov/Asppap1,4,2,6,10,10,1,3,36
Aspergillus parasiticus CBS 117618 v1.0,https://mycocosm.jgi.doe.gov/Asppar1,11,0,22,17,26,6,5,87
Aspergillus parvisclerotigenus CBS 121.62 v1.0,https://mycocosm.jgi.doe.gov/Asppari1,8,4,14,14,20,5,3,68
Aspergillus parvulus CBS 136.61 v1.0,https://mycocosm.jgi.doe.gov/Aspparv1,5,2,18,14,18,6,1,64
Aspergillus penicilloides CBS 540.65 v1.0,https://mycocosm.jgi.doe.gov/Asppeni1,1,1,6,6,11,3,0,28
Aspergillus pernambucoensis CBS 137449 v1.0,https://mycocosm.jgi.doe.gov/Asppern1,5,0,7,10,6,2,2,32
Aspergillus persii CBS 112795 v1.0,https://mycocosm.jgi.doe.gov/Aspper1,6,10,16,24,43,4,3,106
Aspergillus petrakii CBS 105.57 v1.0,https://mycocosm.jgi.doe.gov/Asppet1,7,4,13,20,35,3,4,86
Aspergillus piperis CBS 112811 v1.0,https://mycocosm.jgi.doe.gov/Asppip1,2,6,14,20,30,5,8,85
Aspergillus primulinus CBS 253.94 v1.0,https://mycocosm.jgi.doe.gov/Asppri1,2,0,6,9,7,3,1,28
Aspergillus pseudocaelatus CBS 117616 v1.0,https://mycocosm.jgi.doe.gov/Asppsec1,8,3,15,18,18,10,4,76
Aspergillus pseudodeflectus v1.0,https://mycocosm.jgi.doe.gov/Asppdef1,5,1,9,15,26,4,6,66
Aspergillus pseudofelis IBT 34107 v1.0,https://mycocosm.jgi.doe.gov/Asppsf1,7,3,19,11,30,2,3,75
Aspergillus pseudonomius CBS 119388 v1.0,https://mycocosm.jgi.doe.gov/Asppsen1,6,1,17,19,23,6,3,75
Aspergillus pseudotamarii CBS 117625 v1.0,https://mycocosm.jgi.doe.gov/Asppset1,7,5,16,19,24,7,4,82
Aspergillus pseudoterreus DTO 47-E6 v1.0,https://mycocosm.jgi.doe.gov/Asppterr1,8,5,11,16,23,2,2,67
Aspergillus pseudoustus CBS 123904 v1.0,https://mycocosm.jgi.doe.gov/Asppust1,6,0,15,14,26,3,4,68
Aspergillus pseudoviridinutans IBT 34175 v1.0,https://mycocosm.jgi.doe.gov/Asppsev1,7,1,18,13,28,5,2,74
Aspergillus pulvericola CBS 137327 v1.0,https://mycocosm.jgi.doe.gov/Asppul1,10,6,13,25,34,3,4,95
Aspergillus puulaauensis IBT 32284 v1.0,https://mycocosm.jgi.doe.gov/Asppuu1,9,3,12,15,22,3,1,65
Aspergillus quadrilineatus (floriformis) CBS 937.73 v1.0,https://mycocosm.jgi.doe.gov/Aspquaf1,3,2,9,13,34,8,2,71
Aspergillus quadrilineatus (gemmatus) CBS 853.96 v1.0,https://mycocosm.jgi.doe.gov/Aspquag1,3,3,11,16,29,6,3,71
Aspergillus rambellii 100887 v1.0,https://mycocosm.jgi.doe.gov/Aspramb1,3,2,6,4,11,2,1,29
Aspergillus rambellii SRRC1468,https://mycocosm.jgi.doe.gov/Aspram1,3,1,8,4,11,3,1,31
Aspergillus recurvatus v1.0,https://mycocosm.jgi.doe.gov/Asprec1_1,5,2,8,12,31,6,2,66
Aspergillus restrictus CBS 118.33 v1.0,https://mycocosm.jgi.doe.gov/Aspres1,0,1,4,9,6,2,0,22
Aspergillus rhizopodus v1.0,https://mycocosm.jgi.doe.gov/Asprhi1,4,4,14,6,18,4,3,53
Aspergillus robustus CBS 428.77 v1.0,https://mycocosm.jgi.doe.gov/Asprobu1,2,4,20,16,19,4,5,70
Aspergillus roseoglobulosus CBS112800 v1.0,https://mycocosm.jgi.doe.gov/Aspros1,8,6,16,27,34,4,8,103
Aspergillus saccharolyticus JOP 1030-1 v1.0,https://mycocosm.jgi.doe.gov/Aspsac1,3,2,14,15,11,6,0,51
Aspergillus sclerotiicarbonarius CBS 121057 v1.0,https://mycocosm.jgi.doe.gov/Aspscle1,3,6,14,22,25,6,3,79
Aspergillus sclerotioniger CBS115572 v1.0,https://mycocosm.jgi.doe.gov/Aspscl1,3,5,9,21,21,5,5,69
Aspergillus sclerotiorum CBS 549.65 v1.0,https://mycocosm.jgi.doe.gov/Aspsc1,6,11,14,24,38,4,4,101
Aspergillus sepultus CBS 257.85 v1.0,https://mycocosm.jgi.doe.gov/Aspsep1,0,2,12,16,27,3,4,64
Aspergillus sergii CBS 130017 v1.0,https://mycocosm.jgi.doe.gov/Aspser1,9,0,16,22,26,7,3,83
Aspergillus sesamicola CBS 137324 v1.0,https://mycocosm.jgi.doe.gov/Aspses1,8,3,13,23,31,4,2,84
Aspergillus shendaweii IBT 34197 v1.0,https://mycocosm.jgi.doe.gov/Aspshe1,4,0,7,8,8,4,4,35
Aspergillus siamensis CBS 137452 v1.0,https://mycocosm.jgi.doe.gov/Aspsia1,4,1,17,11,19,4,2,58
Aspergillus silvaticus CBS 128.55 v1.0,https://mycocosm.jgi.doe.gov/Aspsil1,6,4,8,10,21,5,2,56
Aspergillus similis v1.0,https://mycocosm.jgi.doe.gov/Aspsim1_1,5,3,8,15,22,6,2,61
Aspergillus spathulatus CBS 408.89 v1.0,https://mycocosm.jgi.doe.gov/Aspspa1,3,1,2,10,6,2,3,27
Aspergillus spectabilis CBS 429.77A v1.0,https://mycocosm.jgi.doe.gov/Aspspe1_1,6,1,13,20,36,4,3,83
Aspergillus spinosus CBS 483.65 v1.0,https://mycocosm.jgi.doe.gov/Aspspi1,10,2,12,8,14,4,2,52
Aspergillus stella-maris CBS 113639 v1.0,https://mycocosm.jgi.doe.gov/Aspstel1_1,5,1,10,13,36,3,5,73
Aspergillus stercoraria CBS 428.93 v1.0,https://mycocosm.jgi.doe.gov/Aspstec1_1,4,1,7,11,26,4,4,57
Aspergillus steynii IBT 23096 v1.0,https://mycocosm.jgi.doe.gov/Aspste1,9,9,17,22,29,3,4,93
Aspergillus subauricomus CBS 638.78 v1.0,https://mycocosm.jgi.doe.gov/Aspsub1,7,4,18,20,34,3,7,93
Aspergillus sublatus IBT 19356 v1.0,https://mycocosm.jgi.doe.gov/Aspsublat1,4,1,10,13,28,4,3,63
Aspergillus subramanianii CBS 138230 v1.0,https://mycocosm.jgi.doe.gov/Aspsubr1,6,10,14,22,48,4,5,109
Aspergillus sulphureus CBS 550.65 v1.0,https://mycocosm.jgi.doe.gov/Aspsul1,8,9,17,23,36,4,6,103
Aspergillus sydowii CBS 593.65 v1.0,https://mycocosm.jgi.doe.gov/Aspsy1,7,2,13,11,17,2,0,52
Aspergillus taichungensis IBT 19404 v1.0,https://mycocosm.jgi.doe.gov/Asptaic1,5,3,10,9,11,4,1,43
Aspergillus tamarii CBS 117626 v1.0,https://mycocosm.jgi.doe.gov/Asptam1,11,3,19,18,22,6,2,81
Aspergillus tanneri DTO 303-18 v1.0,https://mycocosm.jgi.doe.gov/Asptan1,7,9,23,12,41,5,4,101
Aspergillus templicola CBS 138181 v1.0,https://mycocosm.jgi.doe.gov/Asptem1,9,2,17,21,20,5,2,76
Aspergillus tennesseensis IBT 32283 v1.0,https://mycocosm.jgi.doe.gov/Aspten1,7,2,10,13,22,4,1,59
Aspergillus terreus NIH 2624,https://mycocosm.jgi.doe.gov/Aspte1,5,1,15,17,24,2,2,66
Aspergillus tetrazonus CBS 591.65A v1.0,https://mycocosm.jgi.doe.gov/Asptetr1,4,1,11,14,28,7,2,67
Aspergillus thermomutatus v1.0,https://mycocosm.jgi.doe.gov/Aspthe1,4,4,9,10,19,3,3,52
Aspergillus thesauricus IBT 34227 v1.0,https://mycocosm.jgi.doe.gov/Aspth1,6,1,7,15,21,2,6,58
Aspergillus transcarpathicus CBS 423.68 v1.0,https://mycocosm.jgi.doe.gov/Asptran1,4,0,19,10,17,5,5,60
Aspergillus transmontanensis CBS 130015 v1.0,https://mycocosm.jgi.doe.gov/Asptra1,12,2,14,16,28,5,3,80
Aspergillus trinidadensis IBT 32571 v1.0,https://mycocosm.jgi.doe.gov/Asptri1,5,1,17,25,22,3,1,74
Aspergillus triticus CBS266.81 v1.0,https://mycocosm.jgi.doe.gov/Asptr1,5,2,11,7,23,2,2,52
Aspergillus tsurutae IBT 34206 v1.0,https://mycocosm.jgi.doe.gov/Asptsu1,3,0,7,7,10,3,1,31
Aspergillus tubingensis v1.0,https://mycocosm.jgi.doe.gov/Asptu1,2,7,14,19,31,6,6,85
Aspergillus turcosus IBT 27921 v1.0,https://mycocosm.jgi.doe.gov/Asptur1,3,2,11,11,12,3,2,44
Aspergillus udagawae IFM 46973,https://mycocosm.jgi.doe.gov/Aspuda1,5,3,13,10,25,3,3,62
Aspergillus undulatus CBS 261.88 v1.0,https://mycocosm.jgi.doe.gov/Aspund1_1,5,1,6,15,21,3,3,54
Aspergillus unguis CBS132.55 v1.0,https://mycocosm.jgi.doe.gov/Aspung1,1,2,9,15,13,2,1,43
Aspergillus uvarum CBS 121591 v1.0,https://mycocosm.jgi.doe.gov/Aspuva1,4,3,17,21,21,3,2,71
Aspergillus vadensis CBS 113365 v1.0,https://mycocosm.jgi.doe.gov/Aspvad1,2,5,13,22,27,5,4,78
Aspergillus varians CBS 505.65 v1.0,https://mycocosm.jgi.doe.gov/Aspvar1,9,1,11,10,17,3,2,53
Aspergillus venezuelensis CBS 868.97 v1.0,https://mycocosm.jgi.doe.gov/Aspven1,7,1,13,12,37,4,3,77
Aspergillus versicolor v1.0,https://mycocosm.jgi.doe.gov/Aspve1,6,2,15,13,22,4,1,63
Aspergillus violaceofuscus CBS 115571 v1.0,https://mycocosm.jgi.doe.gov/Aspvio1,6,3,19,20,17,4,3,72
Aspergillus viridinutans CBS 127.56 v1.0,https://mycocosm.jgi.doe.gov/Aspvir1,6,2,10,9,21,3,5,56
Aspergillus waksmanii IBT 31900 v1.0,https://mycocosm.jgi.doe.gov/Aspwak1,2,2,8,8,11,2,3,36
Aspergillus welwitschiae CBS139.54b v1.0,https://mycocosm.jgi.doe.gov/Aspwel1,2,7,15,20,26,4,7,81
Aspergillus wentii v1.0,https://mycocosm.jgi.doe.gov/Aspwe1,2,3,12,14,20,2,5,58
Aspergillus westerdijkiae CBS 112803 v1.0,https://mycocosm.jgi.doe.gov/Aspwest1,10,5,16,22,30,5,6,94
Aspergillus westlandensis CBS 123905 v1.0,https://mycocosm.jgi.doe.gov/Aspwes1,7,5,12,24,27,4,7,86
Aspergillus zonatus v1.0,https://mycocosm.jgi.doe.gov/Aspzo1,1,0,6,8,12,3,2,32
Astrocystis sublimbata CBS 130006 v1.0,https://mycocosm.jgi.doe.gov/Astsub1,5,6,7,14,49,5,9,95
Atractiellales rhizophila v2.0,https://mycocosm.jgi.doe.gov/Atrsp2,0,0,1,3,1,0,6,11
Atropellis piniphila CBS 197.64 v1.0,https://mycocosm.jgi.doe.gov/Atrpi1,3,0,3,7,14,3,3,33
Aulographum hederae v2.0,https://mycocosm.jgi.doe.gov/Aulhe2,0,0,1,4,4,2,0,11
Aureobasidium pullulans NBB 7.2.1 v1.0,https://mycocosm.jgi.doe.gov/AurpulNBB1,0,0,3,11,5,2,0,21
Aureobasidium pullulans var. melanogenum CBS 110374,https://mycocosm.jgi.doe.gov/Aurpu_var_mel1,0,0,2,7,4,2,1,16
Aureobasidium pullulans var. namibiae CBS 147.97,https://mycocosm.jgi.doe.gov/Aurpu_var_nam1,0,0,2,8,4,2,0,16
Aureobasidium pullulans var. pullulans EXF-150,https://mycocosm.jgi.doe.gov/Aurpu_var_pul1,1,0,4,12,6,2,0,25
Aureobasidium pullulans var. subglaciale EXF-2481,https://mycocosm.jgi.doe.gov/Aurpu_var_sub1,0,1,2,11,7,2,1,24
Auricularia subglabra v2.0,https://mycocosm.jgi.doe.gov/Aurde3_1,4,0,1,10,2,0,9,26
Auriculariopsis ampla NL-1724 v1.0,https://mycocosm.jgi.doe.gov/Auramp1,1,0,5,6,2,0,2,16
Auriscalpium vulgare FP105234-Sp v1.0,https://mycocosm.jgi.doe.gov/Aurvu1,0,0,0,6,1,0,12,19
Babjeviella inositovora NRRL Y-12698 v1.0,https://mycocosm.jgi.doe.gov/Babin1,0,0,0,1,0,2,0,3
Backusella circina FSU 941 v1.0,https://mycocosm.jgi.doe.gov/Bacci1,0,0,1,5,2,1,0,9
Basidioascus undulatus,https://mycocosm.jgi.doe.gov/Basun1,0,0,2,1,0,1,0,4
Basidiobolus meristosporus CBS 931.73 v1.0,https://mycocosm.jgi.doe.gov/Basme2finSC,0,0,17,5,4,2,2,30
Batrachochytrium dendrobatidis JAM81 v1.0,https://mycocosm.jgi.doe.gov/Batde5,0,0,1,1,0,2,0,4
Batrachochytrium salamandrivorans BS,https://mycocosm.jgi.doe.gov/Batsa1,0,0,1,1,0,2,0,4
Baudoinia compniacensis UAMH 10762 (4089826) v1.0,https://mycocosm.jgi.doe.gov/Bauco1,0,0,2,6,2,2,1,13
Beauveria bassiana ARSEF 2860,https://mycocosm.jgi.doe.gov/Beaba1,0,3,12,10,11,3,2,41
Beauveria brongniartii RCEF 3172,https://mycocosm.jgi.doe.gov/Corbr1,0,2,9,8,13,4,1,37
Benjaminiella poitrasii RSA 903 v1.0,https://mycocosm.jgi.doe.gov/Benpoi1,0,0,1,5,2,1,0,9
Bifiguratus adelaidae AZ0501,https://mycocosm.jgi.doe.gov/Bifad1,0,0,0,4,2,1,1,8
Bimuria novae-zelandiae CBS 107.79 v1.0,https://mycocosm.jgi.doe.gov/Bimnz1,5,1,6,8,15,5,2,42
Biscogniauxia marginata CBS 124505 v1.0,https://mycocosm.jgi.doe.gov/Bisma1,6,3,4,17,26,3,7,66
Biscogniauxia mediterranea AZ0048 v1.0,https://mycocosm.jgi.doe.gov/Bisme1,2,2,6,10,21,3,6,50
Biscogniauxia mediterranea CBS 129072 v1.0,https://mycocosm.jgi.doe.gov/Bismed1,2,4,5,9,23,2,6,51
Biscogniauxia nummularia v1.0,https://mycocosm.jgi.doe.gov/Bisnum1,1,2,5,10,25,4,10,57
Biscogniauxia sp. FL1348 v1.0,https://mycocosm.jgi.doe.gov/Biscog1,1,6,5,9,20,3,8,52
Bisporella sp. PMI_857 v1.0,https://mycocosm.jgi.doe.gov/Bissp1,6,1,8,9,28,4,3,59
Bjerkandera adusta v1.0,https://mycocosm.jgi.doe.gov/Bjead1_1,0,0,0,14,3,0,4,21
Blakeslea trispora F921 v1.0,https://mycocosm.jgi.doe.gov/Blatri_F921_1,0,0,1,3,1,1,0,6
Blakeslea trispora F986 v1.0,https://mycocosm.jgi.doe.gov/Blatri_F986_2,0,0,1,3,1,1,0,6
Blakeslea trispora NRRL 2456 v1.0,https://mycocosm.jgi.doe.gov/Blatri1,0,0,1,3,1,1,0,6
Blastobotrys (Arxula) adeninivorans,https://mycocosm.jgi.doe.gov/Arxad1,0,0,0,1,0,2,0,3
Blastocladiella britannica v1.0,https://mycocosm.jgi.doe.gov/Blabri1,0,0,0,1,1,1,0,3
Blastomyces dermatitidis ER-3,https://mycocosm.jgi.doe.gov/Blader1,3,0,3,4,1,2,0,13
Blastomyces dermatitidis SLH14081,https://mycocosm.jgi.doe.gov/Blade1,2,0,4,4,1,2,0,13
Blastomyces percursus EI222,https://mycocosm.jgi.doe.gov/Blape1,1,0,4,4,2,2,0,13
Blumeria graminis f. sp. hordei 5874 v1.0,https://mycocosm.jgi.doe.gov/Bgh5874_1,0,0,1,2,1,2,0,6
Blumeria graminis f. sp. hordei DH14,https://mycocosm.jgi.doe.gov/Blugr2,0,0,1,2,1,2,0,6
Blumeria graminis f. sp. hordei Race1,https://mycocosm.jgi.doe.gov/BlugrR1_1,0,0,1,2,1,2,0,6
Blumeria graminis f. sp. tritici 96224 v3.16,https://mycocosm.jgi.doe.gov/Blugra3_16,0,0,1,2,1,2,0,6
Blyttiomyces helicus single-cell v1.0,https://mycocosm.jgi.doe.gov/Blyhe1,0,0,0,1,0,2,0,3
Boeremia exigua MPI-SDFR-AT-0100 v1.0,https://mycocosm.jgi.doe.gov/Boeex1,0,1,4,8,5,2,1,21
Bolbitius vitellinus SZMC-NL-1974 v1.0,https://mycocosm.jgi.doe.gov/Bolvit1,0,1,1,2,2,0,4,10
Boletus coccyginus 2016PMI039 v1.0,https://mycocosm.jgi.doe.gov/Bolcoc1,0,2,1,8,3,0,8,22
Boletus edulis BED1 v4.0,https://mycocosm.jgi.doe.gov/Boled5,0,1,0,9,2,0,8,20
Boletus edulis Přilba v1.0,https://mycocosm.jgi.doe.gov/Boledp1,0,1,0,7,1,1,8,18
Boliniaceae sp. AZ0804 v1.0,https://mycocosm.jgi.doe.gov/Cornip1,1,3,5,15,22,4,3,53
Bombardia bombarda SMH3391-2 v1.0,https://mycocosm.jgi.doe.gov/Bombom1,5,3,4,7,18,4,3,44
Boreostereum radiatum TFC1981-005 v1.0,https://mycocosm.jgi.doe.gov/Borrad1,0,0,0,16,3,1,11,31
Botryobasidium botryosum v1.0,https://mycocosm.jgi.doe.gov/Botbo1,0,0,3,7,6,1,4,21
Botryosphaeria dothidea,https://mycocosm.jgi.doe.gov/Botdo1_1,0,2,17,14,24,4,8,69
Botryozyma mucatilis CBS 9042 v1.0,https://mycocosm.jgi.doe.gov/Botmuc1,0,0,1,1,0,2,0,4
Botrytis cinerea T4,https://mycocosm.jgi.doe.gov/Botcin1,2,1,6,14,14,4,2,43
Botrytis cinerea v1.0,https://mycocosm.jgi.doe.gov/Botci1,2,1,7,14,13,6,2,45
Bretziella fagacearum C519 v1.0,https://mycocosm.jgi.doe.gov/Brefa1,0,0,2,2,3,3,0,10
Bulgaria inquinans CBS118.31 v1.0,https://mycocosm.jgi.doe.gov/Bulin1,0,1,3,8,8,2,0,22
Byssochlamys spectabilis No. 5,https://mycocosm.jgi.doe.gov/Byssp1,2,1,3,10,5,2,3,26
Byssothecium circinans CBS 675.92 v1.0,https://mycocosm.jgi.doe.gov/Bysci1,4,1,6,10,25,3,3,52
Cadophora sp. DSE1049 v1.0,https://mycocosm.jgi.doe.gov/Cadsp1,3,4,6,12,15,2,5,47
Caecomyces churrovis A v1.0,https://mycocosm.jgi.doe.gov/Caecom1,0,0,1,2,7,3,0,13
Caliciopsis orientalis,https://mycocosm.jgi.doe.gov/Calor1,0,1,6,10,11,3,0,31
Calocera cornea v1.0,https://mycocosm.jgi.doe.gov/Calco1,0,0,0,7,2,0,4,13
Calocera viscosa v1.0,https://mycocosm.jgi.doe.gov/Calvi1,0,0,0,4,2,0,2,8
Caloscypha fulgens ATCC 42695 v1.0,https://mycocosm.jgi.doe.gov/Calful1,4,0,1,4,2,2,2,15
Calosphaeria pulchella,https://mycocosm.jgi.doe.gov/Calpu1,0,2,3,10,21,2,1,39
Calycina marina TRa3180A v1.0,https://mycocosm.jgi.doe.gov/Calmar1,1,0,5,4,4,4,1,19
Camillea tinctor CBS 203.56 v1.0,https://mycocosm.jgi.doe.gov/CtCBS203_1,1,7,7,16,21,3,11,66
Candida albicans SC5314,https://mycocosm.jgi.doe.gov/Canalb1,0,0,0,1,0,2,0,3
Candida arabinofermentans NRRL YB-2248 v1.0,https://mycocosm.jgi.doe.gov/Canar1,0,0,0,1,0,2,0,3
Candida boidinii NRRL Y-2332,https://mycocosm.jgi.doe.gov/Canbo1,0,0,0,1,0,2,0,3
Candida dubliniensis CD36,https://mycocosm.jgi.doe.gov/Candu1,0,0,0,1,0,2,0,3
Candida orthopsilosis Co 90-125,https://mycocosm.jgi.doe.gov/Canor1,0,0,0,1,0,2,0,3
Candida parapsilosis CDC317,https://mycocosm.jgi.doe.gov/Canpa1,0,0,0,1,0,2,0,3
Candida tanzawaensis NRRL Y-17324 v1.0,https://mycocosm.jgi.doe.gov/Canta1,0,0,0,1,0,2,0,3
Candida tenuis NRRL Y-1498 v1.0,https://mycocosm.jgi.doe.gov/Cante1,0,0,0,1,0,2,0,3
Candida tropicalis MYA3404,https://mycocosm.jgi.doe.gov/Cantro1,0,0,0,1,0,2,0,3
Cantharellales sp. MUCL 035158 v1.0,https://mycocosm.jgi.doe.gov/Tylas1,0,0,0,7,1,0,3,11
Cantharellus anzutake C23 v1.0,https://mycocosm.jgi.doe.gov/Cananz1,0,0,1,5,1,0,0,7
Capronia coronata CBS 617.96,https://mycocosm.jgi.doe.gov/Capcor1,0,0,3,3,2,3,0,11
Capronia epimyces CBS 606.96,https://mycocosm.jgi.doe.gov/Capep1,0,0,2,7,6,2,0,17
Capronia fungicola CBS 614.96 v1.0,https://mycocosm.jgi.doe.gov/Capfu1,0,0,3,6,4,2,0,15
Capronia semiimmersa CBS27337,https://mycocosm.jgi.doe.gov/Capse1,0,0,4,5,3,2,0,14
Catenaria anguillulae PL171 v2.0,https://mycocosm.jgi.doe.gov/Catan2,0,0,0,1,0,2,0,3
Caulochytrium protostelioides ATCC 52028 single-cell v1.0,https://mycocosm.jgi.doe.gov/Caupr_SCcomb,,,,,,,,0
Caulochytrium protostelioides ATCC 52028 v1.0,https://mycocosm.jgi.doe.gov/Caupr1,0,0,0,2,0,1,0,3
Cenococcum geophilum 1.58 v2.0,https://mycocosm.jgi.doe.gov/Cenge3,3,2,8,6,9,4,1,33
Cephaloascus albidus ATCC 66658 v1.0,https://mycocosm.jgi.doe.gov/Cepal1_1,0,0,0,1,0,2,0,3
Cephaloascus fragrans 12-1022 v1.0,https://mycocosm.jgi.doe.gov/Cepfr1_1,0,0,0,1,0,2,0,3
Ceraceosorus bombacis ATCC 22867,https://mycocosm.jgi.doe.gov/Cerbo1,2,0,3,6,2,2,0,15
Ceraceosorus guamensis MCA 4658 v1.0,https://mycocosm.jgi.doe.gov/Cersp1,1,0,3,7,4,1,0,16
Ceratobasidium sp. 379 v1.0,https://mycocosm.jgi.doe.gov/Cersp379_1,0,0,2,5,1,0,3,11
Ceratobasidium sp. 394 v1.0,https://mycocosm.jgi.doe.gov/Cersp394_1,0,0,3,4,1,0,3,11
Ceratobasidium sp. 423 v1.0,https://mycocosm.jgi.doe.gov/Cersp423_1,0,0,1,3,1,0,7,12
Ceratobasidium sp. anastomosis group I; DN8442 v1.0,https://mycocosm.jgi.doe.gov/CerAGI,0,0,1,9,1,0,2,13
Cercophora caudata CBS 606.72 v1.0,https://mycocosm.jgi.doe.gov/Cercau1,1,2,6,2,12,2,9,34
Cercophora newfieldiana SMH2532-1 v1.0,https://mycocosm.jgi.doe.gov/Cernew1,0,2,4,4,9,2,9,30
Cercophora scortea SMH4131-1 v1.0,https://mycocosm.jgi.doe.gov/Cersc1,0,1,3,8,21,3,3,39
Cercospora berteroae CBS 538.71,https://mycocosm.jgi.doe.gov/Cerbe1,1,1,16,15,12,3,2,50
Cercospora zeae-maydis v1.0,https://mycocosm.jgi.doe.gov/Cerzm1,1,1,8,11,11,2,1,35
Cerinomyces ceraceus ATCC 56525 v1.0,https://mycocosm.jgi.doe.gov/Cercer1,0,0,0,4,2,0,3,9
Cerinomyces crustulinus OMC1686 v1.0,https://mycocosm.jgi.doe.gov/Cercru1,2,0,0,8,4,1,4,19
Ceriporia viridans OMC1683 v1.0,https://mycocosm.jgi.doe.gov/Cervir1,0,0,0,8,2,1,11,22
Ceriporiopsis (Gelatoporia) subvermispora B,https://mycocosm.jgi.doe.gov/Cersu1,0,0,1,9,3,0,9,22
Cerrena unicolor v1.1,https://mycocosm.jgi.doe.gov/Cerun2,1,0,1,9,3,1,13,28
Chaetocladium brefeldii NRRL 2343 v1.0,https://mycocosm.jgi.doe.gov/Chabre1,0,0,1,2,0,1,0,4
Chaetomidium fimeti CBS 168.71 v1.0,https://mycocosm.jgi.doe.gov/Chafi1,0,6,9,4,22,4,2,47
Chaetomium funicola MPI-SDFR-AT-0129 v1.0,https://mycocosm.jgi.doe.gov/Chafu1,0,2,10,4,18,2,2,38
Chaetomium globosum MPI-SDFR-AT-0079 v1.0,https://mycocosm.jgi.doe.gov/Chagl1,1,3,12,5,18,4,3,46
Chaetomium globosum v1.0,https://mycocosm.jgi.doe.gov/Chagl_1,1,3,10,3,17,4,3,41
Chaetomium sp. 1176438 v1.0,https://mycocosm.jgi.doe.gov/Cha1176438,1,2,9,4,19,2,2,39
Chaetomium sp. MPI-CAGE-AT-0009 v1.0,https://mycocosm.jgi.doe.gov/Chame1,0,3,8,9,19,3,4,46
Chaetomium thermophilum var thermophilum DSM 1495,https://mycocosm.jgi.doe.gov/Chathe1,0,0,3,1,4,2,1,11
Chaetosphaeria innumera,https://mycocosm.jgi.doe.gov/Chain1,0,2,7,9,19,2,2,41
Chaetosphaeriaceae sp. FL1790 v1.0,https://mycocosm.jgi.doe.gov/CodFL1790_1,4,2,12,10,32,3,1,64
Chalara longipes BDJ v1.0,https://mycocosm.jgi.doe.gov/Chalo1,2,2,6,14,22,2,4,52
Chalciporus piperatus 201810 CP v1.0,https://mycocosm.jgi.doe.gov/Chapip1,0,1,0,5,2,0,8,16
Chionosphaera apobasidialis 52639 v1.0,https://mycocosm.jgi.doe.gov/Chiap1,0,0,0,2,1,0,0,3
Chionosphaera cuniculicola CBS10063 v1.0,https://mycocosm.jgi.doe.gov/Chicu1,0,0,0,3,1,0,0,4
Choanephora cucurbitarum NRRL2744 (50) v1.0,https://mycocosm.jgi.doe.gov/Chocucu1,0,0,1,5,1,1,0,8
Choiromyces venosus 120613-1 v1.0,https://mycocosm.jgi.doe.gov/Chove1,0,0,1,2,2,2,0,7
Chytridium lagenaria Arg66 v1.0,https://mycocosm.jgi.doe.gov/Chylag1,0,0,2,1,1,1,0,5
Chytriomyces hyalinus JEL632 v1.0,https://mycocosm.jgi.doe.gov/Chyhya1,0,0,2,4,2,2,0,10
Chytriomyces sp. MP 71 v1.0,https://mycocosm.jgi.doe.gov/Chytri1,0,0,0,2,1,1,0,4
Circinella umbellata NRRL1351 v1.0,https://mycocosm.jgi.doe.gov/Cirumb1,0,0,0,4,1,1,0,6
Citeromyces matritensis NRRL Y-2407,https://mycocosm.jgi.doe.gov/Citma1,0,0,0,1,0,2,0,3
Cladochytrium polystomum WB228 v1.0,https://mycocosm.jgi.doe.gov/Clapol1_1,0,0,7,5,4,1,0,17
Cladochytrium replicatum JEL 714 v1.0,https://mycocosm.jgi.doe.gov/Clarep1_1,0,0,1,4,3,2,0,10
Cladonia grayi Cgr/DA2myc/ss v2.0,https://mycocosm.jgi.doe.gov/Clagr3,1,1,2,15,21,5,2,47
Cladophialophora bantiana CBS 173.52,https://mycocosm.jgi.doe.gov/Claba1,1,0,2,8,2,3,0,16
Cladophialophora carrionii CBS 160.54,https://mycocosm.jgi.doe.gov/Claca1,0,0,3,4,4,2,1,14
Cladophialophora immunda CBS83496,https://mycocosm.jgi.doe.gov/Claim1,0,0,2,6,5,2,0,15
Cladophialophora psammophila CBS 110553,https://mycocosm.jgi.doe.gov/Claps1,0,0,2,10,2,2,0,16
Cladophialophora yegresii CBS 114405,https://mycocosm.jgi.doe.gov/Claye1,0,0,1,4,2,2,1,10
Cladorrhinum bulbillosum DJ3 v1.0,https://mycocosm.jgi.doe.gov/Clabul1,1,3,7,5,21,3,3,43
Cladosporium fulvum v1.0,https://mycocosm.jgi.doe.gov/Clafu1,0,1,10,15,8,3,1,38
Cladosporium sphaerospermum UM 843,https://mycocosm.jgi.doe.gov/Clasph1,0,1,4,9,5,3,1,23
Clathrospora elynae CBS 161.51 v1.0,https://mycocosm.jgi.doe.gov/Clael1,1,2,9,7,9,2,1,31
Clavariopsis aquatica WDA-00-1,https://mycocosm.jgi.doe.gov/Claaq1,1,3,5,8,18,4,1,40
Claviceps purpurea 20.1,https://mycocosm.jgi.doe.gov/Clapu1,3,0,6,5,9,2,2,27
Clavicorona pyxidata HHB10654 v1.0,https://mycocosm.jgi.doe.gov/Clapy1,0,0,0,7,6,0,17,30
Clavispora lusitaniae ATCC 42720,https://mycocosm.jgi.doe.gov/Clalu1_2,0,0,0,1,0,2,0,3
Clavispora lusitaniae MJ12 v1.0,https://mycocosm.jgi.doe.gov/ClaluMJ12_1,0,0,0,1,0,2,0,3
Climacocystis borealis CliBor001 v1.0,https://mycocosm.jgi.doe.gov/Clibor1,1,0,2,9,3,0,10,25
Clitocybe gibba IJFM A808 v1.0,https://mycocosm.jgi.doe.gov/Cligib1,1,0,0,14,3,2,13,33
Clitocybe sp. CONT 1119283 v1.0,https://mycocosm.jgi.doe.gov/Cont1119283,1,0,2,15,5,0,18,41
Clohesyomyces aquaticus v1.0,https://mycocosm.jgi.doe.gov/Cloaq1,4,4,5,9,19,4,0,45
Clonostachys rosea CBS125111 v1.0,https://mycocosm.jgi.doe.gov/Cloro1,2,4,16,17,30,2,4,75
Clonostachys sp. CORFU0009 v1.0,https://mycocosm.jgi.doe.gov/Ilyro1,2,3,13,16,32,2,4,72
Coccidioides immitis RS,https://mycocosm.jgi.doe.gov/Cocim1,0,1,5,4,7,3,1,21
Coccidioides posadasii C735 delta SOWgp,https://mycocosm.jgi.doe.gov/Cocpo1_1,0,1,6,3,5,3,1,19
Coccidioides posadasii Silveira,https://mycocosm.jgi.doe.gov/Cocpos1,0,1,6,4,6,2,1,20
Coccodinium bartschii CBS 121709 v1.0,https://mycocosm.jgi.doe.gov/Cocba1,1,2,4,9,5,2,1,24
Coccomyces strobi CBS 202.91 v1.0,https://mycocosm.jgi.doe.gov/Cocst1,1,3,6,12,25,4,1,52
Cochliobolus carbonum 26-R-13 v1.0,https://mycocosm.jgi.doe.gov/Cocca1,1,2,9,8,18,5,6,49
Cochliobolus heterostrophus C4 v1.0,https://mycocosm.jgi.doe.gov/CocheC4_1,2,1,10,8,19,2,6,48
Cochliobolus heterostrophus C5 v2.0,https://mycocosm.jgi.doe.gov/CocheC5_3,3,0,9,8,19,3,6,48
Cochliobolus heterostrophus Hm540,https://mycocosm.jgi.doe.gov/ChetHm540_1,2,0,11,8,18,2,5,46
Cochliobolus lunatus m118 v2.0,https://mycocosm.jgi.doe.gov/Coclu2,1,3,5,12,11,2,2,36
Cochliobolus miyabeanus ATCC 44560 v1.0,https://mycocosm.jgi.doe.gov/Cocmi1,2,1,5,6,15,2,5,36
Cochliobolus sativus ND90Pr v1.0,https://mycocosm.jgi.doe.gov/Cocsa1,3,0,11,6,13,4,5,42
Cochliobolus victoriae FI3 v1.0,https://mycocosm.jgi.doe.gov/Cocvi1,3,2,8,7,14,3,6,43
Coemansia mojavensis RSA 71 v1.0,https://mycocosm.jgi.doe.gov/Coemoj1,0,0,1,0,6,1,0,8
Coemansia reversa NRRL 1564 v1.0,https://mycocosm.jgi.doe.gov/Coere1,0,0,1,0,6,2,0,9
Coemansia spiralis RSA 1278 v1.0,https://mycocosm.jgi.doe.gov/Coespi1,0,0,1,0,11,1,0,13
Cokeromyces recurvatus NRRL 2243 v1.0,https://mycocosm.jgi.doe.gov/Cokrec1,0,0,1,2,2,1,0,6
Colletotrichum abscissum IMI 504890,https://mycocosm.jgi.doe.gov/Colab1,6,3,9,10,18,2,9,57
Colletotrichum acutatum CBS 112980 v2.0,https://mycocosm.jgi.doe.gov/Colac2,5,3,7,11,17,2,8,53
Colletotrichum caudatum CBS131602 v1.0,https://mycocosm.jgi.doe.gov/Colca1,8,3,12,7,22,4,4,60
Colletotrichum cereale CBS 129662 v1.0,https://mycocosm.jgi.doe.gov/Colce1,7,2,9,8,33,5,4,68
Colletotrichum chlorophyti NTL11,https://mycocosm.jgi.doe.gov/Colch1,7,0,6,8,26,5,4,56
Colletotrichum costaricense IMI 309622,https://mycocosm.jgi.doe.gov/Colco1,5,3,9,10,18,2,9,56
Colletotrichum cuscutae IMI 304802,https://mycocosm.jgi.doe.gov/Colcu1,5,2,7,13,13,4,7,51
Colletotrichum eremochloae CBS129661 v1.0,https://mycocosm.jgi.doe.gov/Coler1,8,2,9,10,29,5,6,69
Colletotrichum falcatum MAFF306170 v1.0,https://mycocosm.jgi.doe.gov/Colfa1,6,3,7,9,23,4,4,56
Colletotrichum fioriniae PJ7,https://mycocosm.jgi.doe.gov/Colfi1,5,3,7,9,20,3,8,55
Colletotrichum gloeosporioides Cg-14,https://mycocosm.jgi.doe.gov/Colgl1,7,0,10,11,24,3,11,66
Colletotrichum godetiae CBS 193.32 v1.0,https://mycocosm.jgi.doe.gov/Colgo1,7,2,8,8,19,3,8,55
Colletotrichum graminicola M1.001,https://mycocosm.jgi.doe.gov/Colgr1,7,4,4,9,33,1,3,61
Colletotrichum higginsianum IMI 349063,https://mycocosm.jgi.doe.gov/Colhig2,7,4,12,11,28,5,6,73
Colletotrichum incanum MAFF 238712,https://mycocosm.jgi.doe.gov/Colin1,7,0,16,9,24,3,3,62
Colletotrichum lupini CBS 109225 v1.0,https://mycocosm.jgi.doe.gov/Collu1,6,5,8,11,18,2,8,58
Colletotrichum lupini IMI 504893,https://mycocosm.jgi.doe.gov/Collup1,6,4,10,10,18,3,8,59
Colletotrichum melonis CBS 134730,https://mycocosm.jgi.doe.gov/Colme1,5,4,8,10,18,2,8,55
Colletotrichum navitas CBS125086 v1.0,https://mycocosm.jgi.doe.gov/Colna1,7,2,11,8,31,6,4,69
Colletotrichum nymphaeae SA-01,https://mycocosm.jgi.doe.gov/Colny1,5,3,8,9,22,2,7,56
Colletotrichum orbiculare 104-T,https://mycocosm.jgi.doe.gov/Colorb1,6,3,9,10,20,3,4,55
Colletotrichum orchidophilum IMI 309357,https://mycocosm.jgi.doe.gov/Color1,5,2,9,9,16,2,4,47
Colletotrichum paranaense IMI 384185,https://mycocosm.jgi.doe.gov/Colpa1,5,4,8,11,17,2,7,54
Colletotrichum phormii CBS102054 v1.0,https://mycocosm.jgi.doe.gov/Colph1,8,3,12,7,17,3,8,58
Colletotrichum salicis CBS607.94,https://mycocosm.jgi.doe.gov/Colsa1,7,2,9,7,16,2,6,49
Colletotrichum simmondsii CBS122122,https://mycocosm.jgi.doe.gov/Colsi1,5,4,10,9,21,2,8,59
Colletotrichum somersetensis CBS 131599 v1.0,https://mycocosm.jgi.doe.gov/Colso1,7,4,10,11,26,2,3,63
Colletotrichum sp. CBS 101611,https://mycocosm.jgi.doe.gov/Colsp1,5,4,8,10,19,2,9,57
Colletotrichum sublineola CBS 131301 v1.0,https://mycocosm.jgi.doe.gov/Colsu1,7,6,8,8,26,3,6,64
Colletotrichum sublineola TX430BB,https://mycocosm.jgi.doe.gov/Colsub1,6,5,12,11,29,5,3,71
Colletotrichum tamarilloi CBS 129955,https://mycocosm.jgi.doe.gov/Colta1,5,4,9,10,17,3,8,56
Colletotrichum tofieldiae 0861,https://mycocosm.jgi.doe.gov/Colto1,11,1,12,9,25,2,4,64
Colletotrichum tofieldiae CBS 168.49,https://mycocosm.jgi.doe.gov/Coltof1,10,1,10,7,23,3,5,59
Colletotrichum zoysiae MAFF235873 v1.0,https://mycocosm.jgi.doe.gov/Colzo1,8,3,9,7,27,4,5,63
Conidiobolus coronatus NRRL28638 v1.0,https://mycocosm.jgi.doe.gov/Conco1,0,0,1,7,0,3,0,11
Conidiobolus thromboides FSU 785 v1.0,https://mycocosm.jgi.doe.gov/Conth1,0,0,0,4,1,1,0,6
Coniella lustricola B22-T-1 v1.0,https://mycocosm.jgi.doe.gov/Pilidi1,0,2,3,10,14,3,1,33
Coniochaeta ligniaria CBS 111746,https://mycocosm.jgi.doe.gov/Conli1,0,0,4,4,14,3,3,28
Coniochaeta ligniaria NRRL 30616 v1.0,https://mycocosm.jgi.doe.gov/Conlig1,0,1,4,4,15,2,2,28
Coniochaeta sp. 2T2.1 v1.0,https://mycocosm.jgi.doe.gov/Conioc1,1,4,12,9,31,5,4,66
Coniochaeta sp. PMI_546 v1.0,https://mycocosm.jgi.doe.gov/ConPMI546,0,1,7,3,10,2,2,25
Coniophora olivacea MUCL 20566 v1.0,https://mycocosm.jgi.doe.gov/Conol1,0,3,1,13,3,0,18,38
Coniophora puteana v1.0,https://mycocosm.jgi.doe.gov/Conpu1,0,1,1,17,2,2,17,40
Coniosporium apollinis CBS 100218,https://mycocosm.jgi.doe.gov/Conap1,0,1,1,3,3,2,1,11
Conocybe apala SZMC-NL-8967 v1.0,https://mycocosm.jgi.doe.gov/Conapa1,0,0,1,3,3,0,6,13
Coprinellus angulatus CBS 144469 v1.0,https://mycocosm.jgi.doe.gov/Copang1,1,0,1,4,3,1,6,16
Coprinellus micaceus FP101781 v2.0,https://mycocosm.jgi.doe.gov/Copmic2,0,2,1,4,4,0,7,18
Coprinellus pellucidus v1.0,https://mycocosm.jgi.doe.gov/Coppel1,0,0,1,2,2,0,9,14
Coprinopsis cinerea,https://mycocosm.jgi.doe.gov/Copci1,1,0,1,3,2,0,6,13
Coprinopsis cinerea AmutBmut pab1-1 v1.0,https://mycocosm.jgi.doe.gov/Copci_AmutBmut1,1,0,1,3,3,0,6,14
Coprinopsis marcescibilis CBS121175 v1.0,https://mycocosm.jgi.doe.gov/Copmar1,2,0,1,3,3,0,4,13
Coprinopsis sclerotiger v1.0,https://mycocosm.jgi.doe.gov/Copscl1,1,0,1,3,2,0,5,12
Coprinopsis sp. MPI-PUGE-AT-0042 v1.0,https://mycocosm.jgi.doe.gov/Copph3,1,0,1,3,3,0,9,17
Cordyceps militaris CM01,https://mycocosm.jgi.doe.gov/Cormi1,1,2,5,10,9,4,1,32
Cordyceps sp. RAO 2017,https://mycocosm.jgi.doe.gov/CorRAO_2017_1,2,1,12,11,13,5,1,45
Corollospora maritima CBS 119819 v2.0,https://mycocosm.jgi.doe.gov/Corma2,0,1,5,2,10,2,1,21
Cortinarius aff. campbellae TAS5-PSC4363 v1.0,https://mycocosm.jgi.doe.gov/Corcam1,0,1,0,1,7,2,22,33
Cortinarius austrovenetus TL2843-KIS7R v1.0,https://mycocosm.jgi.doe.gov/Coraus1,0,2,0,2,8,0,17,29
Cortinarius glaucopus AT 2004 276 v2.0,https://mycocosm.jgi.doe.gov/Corgl3,0,1,0,6,7,1,18,33
Cortinarius sp. KIS3-TL2766 v1.0,https://mycocosm.jgi.doe.gov/CorKIS3_1,0,2,0,9,7,2,8,28
Corynespora cassiicola CCP v1.0,https://mycocosm.jgi.doe.gov/Corca1,2,2,4,12,25,2,3,50
Crassisporium funariophilum CBS 144457 v1.0,https://mycocosm.jgi.doe.gov/Crafun1,2,1,1,5,4,0,6,19
Crepidotus cesatii CBS 511.95 v1.0,https://mycocosm.jgi.doe.gov/Creces1,0,1,0,3,2,1,7,14
Crepidotus variabilis CBS 506.95 v1.0,https://mycocosm.jgi.doe.gov/Crevar1,0,2,0,4,2,2,8,18
Cristinia sonorae KKN 215 v1.0,https://mycocosm.jgi.doe.gov/Crison1,0,0,0,14,2,0,5,21
Cronartium quercuum f. sp. fusiforme G11 v1.0,https://mycocosm.jgi.doe.gov/Croqu1,0,0,0,5,2,0,2,9
Crucibulum laeve CBS 166.37 v1.0,https://mycocosm.jgi.doe.gov/Crula1,2,0,1,18,4,0,19,44
Crustoderma dryinum OMC1663 v1.0,https://mycocosm.jgi.doe.gov/Crudry1,1,0,0,11,6,2,14,34
Cryomyces antarcticus CBS 116301 v3.0,https://mycocosm.jgi.doe.gov/Cryan3,0,0,1,9,1,3,0,14
Cryomyces minteri CCFEE 5187,https://mycocosm.jgi.doe.gov/Crymi1,0,0,2,9,2,4,0,17
Cryphonectria parasitica EP155 v2.0,https://mycocosm.jgi.doe.gov/Crypa2,2,4,5,9,18,4,4,46
Cryptococcus amylolentus CBS 6039,https://mycocosm.jgi.doe.gov/Cryam1,0,0,0,3,0,1,0,4
Cryptococcus curvatus ATCC 20509 v1.0,https://mycocosm.jgi.doe.gov/Crycu1,0,0,0,1,0,1,0,2
Cryptococcus gattii CA1873,https://mycocosm.jgi.doe.gov/CgaCA1873_1,0,0,0,2,0,1,0,3
Cryptococcus gattii VGII 2001/935-1,https://mycocosm.jgi.doe.gov/CgaVGII_1,0,0,0,2,0,1,0,3
Cryptococcus gattii VGIV IND107,https://mycocosm.jgi.doe.gov/CgaVGIV_1,0,0,0,2,0,1,0,3
Cryptococcus gattii WM276,https://mycocosm.jgi.doe.gov/CgaWM276_1,0,0,0,2,0,1,0,3
Cryptococcus neoformans var neoformans JEC21,https://mycocosm.jgi.doe.gov/Cryne_JEC21_1,0,0,0,2,0,1,0,3
Cryptococcus neoformans var. grubii H99,https://mycocosm.jgi.doe.gov/Cryne_H99_1,0,0,0,2,0,1,0,3
Cryptococcus terricola JCM 24523 v1.0,https://mycocosm.jgi.doe.gov/Cryte1,0,0,0,3,1,0,0,4
Cryptococcus wingfieldii CBS 7118,https://mycocosm.jgi.doe.gov/Tsuwi1,0,0,0,3,0,1,0,4
Cryptodiaporthe populea CFL2025 v1.0,https://mycocosm.jgi.doe.gov/Crypo1,5,4,9,8,28,2,4,60
Cryptodiaporthe sp. AZ0812 v1.0,https://mycocosm.jgi.doe.gov/Crypto1,5,5,9,17,15,3,3,57
Cucurbitaria berberidis CBS 394.84 v1.0,https://mycocosm.jgi.doe.gov/Cucbe1,0,1,4,5,10,2,1,23
Cunninghamella echinulata NRRL 1382 v1.0,https://mycocosm.jgi.doe.gov/Cunech1,0,0,1,0,1,1,0,3
Cyathus striatus AH 40144 v1.0,https://mycocosm.jgi.doe.gov/Cyastr2,2,2,2,16,1,1,20,44
Cyberlindnera fabianii 65,https://mycocosm.jgi.doe.gov/Cybfa1,0,0,0,1,0,2,0,3
Cyberlindnera jadinii NRRL Y-1542 v1.0,https://mycocosm.jgi.doe.gov/Cybja1,0,0,0,1,0,2,0,3
Cylindrobasidium torrendii FP15055 v1.0,https://mycocosm.jgi.doe.gov/Cylto1,0,0,1,6,2,0,9,18
Cylindrocarpon olidum MPI-CAGE-CH-0241 v1.0,https://mycocosm.jgi.doe.gov/Cylol1,1,5,8,12,15,4,5,50
Cyphellophora europaea CBS 101466,https://mycocosm.jgi.doe.gov/Cypeu1,0,0,4,5,2,2,0,13
Cystobasidium minutum MCA 4210 v1.0,https://mycocosm.jgi.doe.gov/Rhomi1,0,0,0,3,1,0,0,4
Cystostereum murrayi CysMur001 v1.0,https://mycocosm.jgi.doe.gov/Cysmur1,0,0,1,16,4,0,7,28
Cytidiella melzeri FP 102339 v1.0,https://mycocosm.jgi.doe.gov/Cytmel1,0,0,0,9,1,0,3,13
Cytospora chrysosperma CFL2056 v1.0,https://mycocosm.jgi.doe.gov/Cytch1,2,3,6,8,17,4,4,44
Dacrymyces fennicus OMC1656 v1.0,https://mycocosm.jgi.doe.gov/Dactor1,0,0,0,5,2,0,3,10
Dacrymyces tortus OMC1693 v1.0,https://mycocosm.jgi.doe.gov/Dactort1,2,0,1,10,5,0,10,28
Dacryonaema rufum OMC1653 v1.0,https://mycocosm.jgi.doe.gov/Dacruf1,0,0,1,13,2,0,6,22
Dacryopinax primogenitus DJM 731 SSP1 v1.0,https://mycocosm.jgi.doe.gov/Dacsp1,0,0,0,6,2,0,2,10
Dactylonectria estremocensis MPI-CAGE-AT-0021 v1.0,https://mycocosm.jgi.doe.gov/Daces1,1,3,8,10,12,4,2,40
Dactylonectria macrodidyma MPI-CAGE-AT-0147 v1.0,https://mycocosm.jgi.doe.gov/Dacma1,2,5,7,11,16,4,5,50
Daedalea quercina v1.0,https://mycocosm.jgi.doe.gov/Daequ1,0,1,0,7,5,1,9,23
Daldinia bambusicola CBS 122872 v1.0,https://mycocosm.jgi.doe.gov/Dalba1,2,2,7,9,23,3,4,50
Daldinia caldariorum CBS 122874 v1.0,https://mycocosm.jgi.doe.gov/Dalcal1,3,1,5,8,23,4,2,46
Daldinia decipiens CBS 113046 v1.0,https://mycocosm.jgi.doe.gov/Daldec1,2,1,5,10,22,3,5,48
Daldinia eschscholtzii EC12 v1.0,https://mycocosm.jgi.doe.gov/DalEC12_1,2,1,6,11,23,3,6,52
Daldinia eschscholtzii FL0578 v1.0,https://mycocosm.jgi.doe.gov/Dales1,2,1,6,12,21,3,5,50
Daldinia grandis CBS 114736 v1.0,https://mycocosm.jgi.doe.gov/Dalgra1,2,1,5,9,19,3,4,43
Daldinia loculata AZ0526 v2.0,https://mycocosm.jgi.doe.gov/DallocAZ0526_2,3,1,4,8,19,3,3,41
Daldinia loculata CBS 113971 v1.0,https://mycocosm.jgi.doe.gov/Dalloc1,3,0,5,9,20,6,5,48
Daldinia loculatoides CBS 113279 v1.0,https://mycocosm.jgi.doe.gov/Dallocu1,3,1,5,12,20,3,4,48
Daldinia sp. FL1419 v1.0,https://mycocosm.jgi.doe.gov/DaFL1419_1,4,1,4,10,18,3,2,42
Daldinia vernicosa CBS 139.73 v1.0,https://mycocosm.jgi.doe.gov/Dalver1,2,0,8,7,25,3,6,51
Darksidea alpha DSE7016 v1.0,https://mycocosm.jgi.doe.gov/Daral1,6,4,11,11,44,5,6,87
Darksidea alpha DSE7024 v1.0,https://mycocosm.jgi.doe.gov/Daralp1,4,5,9,11,39,5,8,81
Debaryomyces fabryi CBS 789,https://mycocosm.jgi.doe.gov/Debfa1,0,0,0,1,0,2,0,3
Debaryomyces hansenii,https://mycocosm.jgi.doe.gov/Debha1,0,0,0,1,0,2,0,3
Debaryomyces subglobosus dep8 v1.0,https://mycocosm.jgi.doe.gov/Debsub1,0,0,0,1,0,2,0,3
Decorospora gaudefroyi v1.0,https://mycocosm.jgi.doe.gov/Decga1,0,2,3,4,10,2,0,21
Dekkera bruxellensis CBS 2499 v2.0,https://mycocosm.jgi.doe.gov/Dekbr2,0,0,0,1,0,2,0,3
Delitschia confertaspora ATCC 74209 v1.0,https://mycocosm.jgi.doe.gov/Delco1,3,0,5,9,11,2,0,30
Delphinella strobiligena CBS 735.71 v1.0,https://mycocosm.jgi.doe.gov/Delst1,0,0,5,9,3,2,2,21
Dendrothele bispora CBS 962.96 v1.0,https://mycocosm.jgi.doe.gov/Denbi1,0,0,5,35,10,0,37,87
Dendrothele microspora FP 101998 v1.0,https://mycocosm.jgi.doe.gov/Denmi1,2,0,5,16,6,1,11,41
Dendryphion nanum MPI-CAGE-CH-0243 v1.0,https://mycocosm.jgi.doe.gov/Denna1,0,0,8,7,13,4,1,33
Dentipellis sp. KUC8613 v1.0,https://mycocosm.jgi.doe.gov/Densp1,0,0,0,13,1,1,6,21
Diaporthaceae sp. PMI_573 v1.0,https://mycocosm.jgi.doe.gov/DiaPMI573_1,11,7,16,24,62,6,11,137
Diaporthe ampelina UCDDA912,https://mycocosm.jgi.doe.gov/Diaam1,5,3,4,14,24,5,4,59
Diaporthe helianthi str. 7/96,https://mycocosm.jgi.doe.gov/Diahe1,7,3,12,14,35,4,6,81
Dibaeis baeomyces,https://mycocosm.jgi.doe.gov/Dibbae1,0,0,4,14,25,3,5,51
Dichomitus squalens CBS463.89 v1.0,https://mycocosm.jgi.doe.gov/Dicsqu463_1,0,0,2,12,3,0,10,27
Dichomitus squalens CBS464.89 v1.0,https://mycocosm.jgi.doe.gov/Dicsqu464_1,0,0,2,10,4,0,11,27
Dichomitus squalens LYAD-421 SS1 v1.0,https://mycocosm.jgi.doe.gov/Dicsq1,0,0,2,11,4,0,9,26
Dichomitus squalens OM18370.1 v1.0,https://mycocosm.jgi.doe.gov/Dicsqu18370_1,0,0,2,11,4,0,9,26
Dichotomocladium elegans RSA 919- v1.0,https://mycocosm.jgi.doe.gov/Dicele1,0,0,0,1,1,1,0,3
Dichotomocladium robustum RSA 2353+ v1.0,https://mycocosm.jgi.doe.gov/Dicrob1,0,0,0,4,1,1,0,6
Didymella exigua CBS 183.55 v1.0,https://mycocosm.jgi.doe.gov/Didex1,1,0,3,4,8,2,0,18
Didymella zeae-maydis 3018,https://mycocosm.jgi.doe.gov/Didma1,1,0,4,7,10,2,1,25
Didymocrea sadasivanii CBS 438.65 v1.0,https://mycocosm.jgi.doe.gov/Didsa1,1,1,8,9,15,2,2,38
Digitatispora marina 008cD1.1 v1.0,https://mycocosm.jgi.doe.gov/Digmar1,0,1,1,4,1,0,9,16
Dimargaris cristalligena RSA 468 single-cell v1.0,https://mycocosm.jgi.doe.gov/DimcrSC1,0,0,21,7,0,2,0,30
Dioszegia cryoxerica v1.0,https://mycocosm.jgi.doe.gov/Diocr1,0,0,0,4,0,2,0,6
Diplodia seriata DS831,https://mycocosm.jgi.doe.gov/Dipse1,0,0,3,11,8,1,2,25
Disciotis venosa NRRL 24433 v1.0,https://mycocosm.jgi.doe.gov/Disven1,0,0,1,5,2,2,0,10
Dissoconium aciculare v1.0,https://mycocosm.jgi.doe.gov/Disac1,1,1,5,11,8,2,1,29
Dissophora decumbens NRRL 22416 v1.0,https://mycocosm.jgi.doe.gov/Disdec1,0,0,0,1,1,1,0,3
Dissophora ornata CBS 347.77 v1.0,https://mycocosm.jgi.doe.gov/Disorn1,0,0,2,3,1,1,0,7
Dothideomycetes sp. P12C66 v1.0,https://mycocosm.jgi.doe.gov/DotP12C66,2,0,1,7,5,2,1,18
Dothidotthia symphoricarpi v1.0,https://mycocosm.jgi.doe.gov/Dotsy1,2,0,6,6,12,2,3,31
Dothistroma septosporum NZE10 v1.0,https://mycocosm.jgi.doe.gov/Dotse1,1,1,5,9,4,3,1,24
Drechmeria coniospora ARSEF 6962,https://mycocosm.jgi.doe.gov/Dreco1,1,1,7,6,5,5,1,26
Drechslerella stenobrocha 248,https://mycocosm.jgi.doe.gov/Drest1,0,1,3,1,0,2,0,7
Durotheca rogersii YMJ 92031201 v1.0,https://mycocosm.jgi.doe.gov/Durrog2,2,0,8,9,21,4,6,50
Earliella scabrosa CIRM-BRFM 1817 v1.0,https://mycocosm.jgi.doe.gov/Earsca1,0,0,2,12,3,0,16,33
Echinodontium tinctorium Aho-80 v1.0,https://mycocosm.jgi.doe.gov/Echtin1,0,0,2,10,1,0,6,19
Edhazardia aedis USNM 41457,https://mycocosm.jgi.doe.gov/Edhae1,,,,,,,,0
Elaphomyces granulatus OSC145934,https://mycocosm.jgi.doe.gov/Elagr1,0,3,3,1,15,5,2,29
Ellisomyces anomalus CBS 243.57 v2.0,https://mycocosm.jgi.doe.gov/Ellano2,0,0,1,4,2,1,0,8
Elsinoe ampelina CECT 20119 v1.0,https://mycocosm.jgi.doe.gov/Elsamp1,1,1,5,6,3,2,1,19
Elytroderma deformans CBS183.68 v1.0,https://mycocosm.jgi.doe.gov/Elyde1,1,5,6,20,33,5,2,72
Emergomyces pasteurianus UAMH 9510,https://mycocosm.jgi.doe.gov/Emepa1,2,0,3,4,1,2,0,12
Emericellopsis sp. TS7 v1.0,https://mycocosm.jgi.doe.gov/AcreTS7_1,1,1,8,8,6,2,2,28
Emmonsia crescens UAMH 4076,https://mycocosm.jgi.doe.gov/Emmcr1,1,0,3,5,1,3,0,13
Emmonsia parva UAMH 130,https://mycocosm.jgi.doe.gov/Emmpa1,1,0,4,5,2,2,0,14
Encephalitozoon cuniculi GB-M1,https://mycocosm.jgi.doe.gov/Enccu1,,,,,,,,0
Encephalitozoon hellem ATCC 50504,https://mycocosm.jgi.doe.gov/Enche1,,,,,,,,0
Encephalitozoon intestinalis ATCC 50506,https://mycocosm.jgi.doe.gov/Encin1,,,,,,,,0
Encephalitozoon romaleae SJ-2008,https://mycocosm.jgi.doe.gov/Encro1,,,,,,,,0
Endocarpon pallidulum Enpa,https://mycocosm.jgi.doe.gov/Endpal1,2,1,7,6,9,3,2,30
Endocarpon pusillum Z07020,https://mycocosm.jgi.doe.gov/EndpusZ1,2,2,3,4,16,3,2,32
Endogone sp FLAS 59071,https://mycocosm.jgi.doe.gov/Endsp1,0,0,0,2,1,1,0,4
Enterocytozoon bieneusi H348,https://mycocosm.jgi.doe.gov/Entbi1,,,,,,,,0
Enterocytozoon hepatopenaei TH1,https://mycocosm.jgi.doe.gov/Enthe1,,,,,,,,0
Enterospora canceri GB1,https://mycocosm.jgi.doe.gov/Entca1,,,,,,,,0
Entoleuca mammata CFL468 v1.0,https://mycocosm.jgi.doe.gov/Entma1,1,3,8,9,25,3,4,53
Entophlyctis helioformis JEL805 v1.0,https://mycocosm.jgi.doe.gov/Enthel1,0,0,0,1,1,1,0,3
Epicoccum nigrum cont 1108929 v1.0,https://mycocosm.jgi.doe.gov/Epini1,2,2,6,6,8,2,1,27
Epithele typhae CBS 203.58 v1.0,https://mycocosm.jgi.doe.gov/Epityp1,0,0,2,12,4,0,9,27
Eremomyces bilateralis CBS 781.70 v1.0,https://mycocosm.jgi.doe.gov/Erebi1,0,1,2,1,3,2,1,10
Eremothecium cymbalariae DBVPG 7215,https://mycocosm.jgi.doe.gov/Erecy1,0,0,0,1,0,2,0,3
Eremothecium gossypii ATCC 10895,https://mycocosm.jgi.doe.gov/Ashgo1_1,0,0,0,1,0,2,0,3
Eremothecium gossypii FDAG1,https://mycocosm.jgi.doe.gov/Erego1,0,0,0,1,0,2,0,3
Erysiphe necator c,https://mycocosm.jgi.doe.gov/Erynec1,0,0,1,2,0,2,0,5
Erysiphe pisi Palampur-1 v2.0,https://mycocosm.jgi.doe.gov/Erypi2,0,0,1,3,1,2,0,7
Erysiphe pulchra Cflorida,https://mycocosm.jgi.doe.gov/Erypu1,0,0,1,2,2,2,0,7
Erythrobasidium hasegawianum ATCC 9536 v1.0,https://mycocosm.jgi.doe.gov/Eryha1,0,0,0,3,1,0,0,4
Escovopsis weberi CC031208-10,https://mycocosm.jgi.doe.gov/Escweb1,3,2,2,3,7,2,1,20
Eurotiomycetes sp. JF 03-3F Goopy v1.0,https://mycocosm.jgi.doe.gov/EurotioJF033F_1,0,0,4,8,3,2,0,17
Eurotiomycetes sp. JF 03-4F Slimy v1.0,https://mycocosm.jgi.doe.gov/EurotioJF034F_1,0,0,4,8,3,2,0,17
Eurotium rubrum v1.0,https://mycocosm.jgi.doe.gov/Eurhe1,2,0,4,8,12,2,1,29
Eutypa lata UCREL1,https://mycocosm.jgi.doe.gov/Eutla1,5,2,6,14,27,8,2,64
Exidia glandulosa v1.0,https://mycocosm.jgi.doe.gov/Exigl1,3,0,2,9,3,1,17,35
Exobasidium maculosum A7-4 v1.0,https://mycocosm.jgi.doe.gov/Exomac1,0,0,3,6,0,1,0,10
Exobasidium vaccinii MPITM v1.0,https://mycocosm.jgi.doe.gov/Exova1,0,0,1,4,1,1,0,7
Exophiala alcalophila ATCC 48519 v1.0,https://mycocosm.jgi.doe.gov/Exoalc1,0,0,3,3,3,2,0,11
Exophiala alcalophila J33 v1.0,https://mycocosm.jgi.doe.gov/Exoalc1_J33,0,0,3,3,3,2,0,11
Exophiala aquamarina CBS 119918,https://mycocosm.jgi.doe.gov/Exoaq1,0,0,4,8,5,5,1,23
Exophiala dermatitidis UT8656,https://mycocosm.jgi.doe.gov/Exode1,0,0,4,3,2,3,0,12
Exophiala mesophila CBS40295,https://mycocosm.jgi.doe.gov/Exome1,0,0,2,5,1,2,0,10
Exophiala oligosperma CBS72588,https://mycocosm.jgi.doe.gov/Exool1,0,0,4,5,2,3,0,14
Exophiala sideris CBS121828,https://mycocosm.jgi.doe.gov/Exosi1,0,0,2,3,2,2,0,9
Exophiala sp. JF 06-1F Fuzzy v1.0,https://mycocosm.jgi.doe.gov/ExoJF061F_1,0,0,4,9,2,3,0,18
Exophiala spinifera CBS89968,https://mycocosm.jgi.doe.gov/Exosp1,0,0,3,8,3,2,0,16
Exophiala xenobiotica CBS118157,https://mycocosm.jgi.doe.gov/Exoxe1,0,0,2,4,5,3,0,14
Fellomyces penicillatus Phaff54-35 v1.0,https://mycocosm.jgi.doe.gov/Felpe1,0,0,0,4,0,1,0,5
Fenestella fenestrata ATCC 66461 v1.0,https://mycocosm.jgi.doe.gov/Fenfe1,0,1,8,4,9,2,1,25
Fennellomyces linderi CBS 158.54 v1.0,https://mycocosm.jgi.doe.gov/FenlinCB54_1,0,0,0,5,1,1,0,7
Fennellomyces sp. T-0311 v1.0,https://mycocosm.jgi.doe.gov/Fenlin1,0,0,0,5,1,1,0,7
Fibroporia radiculosa TFFH 294,https://mycocosm.jgi.doe.gov/Fibra1,0,0,0,11,11,0,8,30
Fibulobasidium inconspicuum Phaff89-39 v1.0,https://mycocosm.jgi.doe.gov/Fibin1,0,0,0,3,0,1,0,4
Fibulorhizoctonia psychrophila CBS 109695 v1.0,https://mycocosm.jgi.doe.gov/Fibsp1,0,1,0,26,3,2,4,36
Filobasidium floriforme CBS 6241 v1.0,https://mycocosm.jgi.doe.gov/Filflo1,0,0,1,4,1,0,0,6
Filobasidium wieringae UCDFST 05-544 v1.0,https://mycocosm.jgi.doe.gov/Crywi1,0,0,1,4,1,0,0,6
Fimicolochytrium jonesii JEL569 v1.0,https://mycocosm.jgi.doe.gov/Fimjon1,0,1,3,2,2,1,0,9
Fistulina hepatica v1.0,https://mycocosm.jgi.doe.gov/Fishe1,0,0,2,10,3,0,4,19
Flagelloscypha sp. PMI_526 v1.0,https://mycocosm.jgi.doe.gov/FlaPMI526_1,4,0,0,4,4,0,13,25
Flavodon flavus 38 v1.0,https://mycocosm.jgi.doe.gov/Flafl1,0,0,0,9,1,0,6,16
Fomes fomentarius CIRM-BRFM 1821 v1.0,https://mycocosm.jgi.doe.gov/Fomfom1,0,0,1,11,5,1,15,33
Fomitiporia mediterranea v1.0,https://mycocosm.jgi.doe.gov/Fomme1,0,0,1,4,5,1,16,27
Fomitopsis betulina CIRM-BRFM 1772 v1.1,https://mycocosm.jgi.doe.gov/Pipbet1_1,1,0,0,5,5,0,8,19
Fomitopsis pinicola FP-58527 SS1 v3.0,https://mycocosm.jgi.doe.gov/Fompi3,0,0,0,8,7,0,12,27
Fomitopsis rosea Sig1Fomros20-ss v1.0,https://mycocosm.jgi.doe.gov/Fomro1,2,0,0,10,7,1,10,30
Fonsecaea erecta CBS 125763,https://mycocosm.jgi.doe.gov/Foner1,0,0,1,6,3,3,0,13
Fonsecaea monophora CBS 269.37,https://mycocosm.jgi.doe.gov/Fonmo1,0,0,4,7,3,2,0,16
Fonsecaea multimorphosa CBS 102226,https://mycocosm.jgi.doe.gov/Fonmu1,0,0,2,8,4,2,0,16
Fonsecaea nubica CBS 269.64,https://mycocosm.jgi.doe.gov/Fonnu1,0,0,3,7,3,2,0,15
Fonsecaea pedrosoi CBS 271.37,https://mycocosm.jgi.doe.gov/Fonpe1,0,0,3,8,3,2,0,16
Friedmanniomyces endolithicus CCFEE 5311,https://mycocosm.jgi.doe.gov/Frien1,0,0,2,8,2,4,0,16
Friedmanniomyces simplex CCFEE 5184,https://mycocosm.jgi.doe.gov/Frisi1,0,0,1,4,2,2,0,9
Fusarium bataticola FSSC 23 v1.0,https://mycocosm.jgi.doe.gov/FusspF23_1,1,2,9,9,13,2,1,37
Fusarium commune MPI-SDFR-AT-0072 v1.0,https://mycocosm.jgi.doe.gov/Fusco1,3,3,8,13,12,3,8,50
Fusarium cucurbiticola FSSC 10 v1.0,https://mycocosm.jgi.doe.gov/FusspF10_1,2,0,7,8,10,2,1,30
Fusarium culmorum UK99,https://mycocosm.jgi.doe.gov/Fuscu1,0,1,8,10,7,3,6,35
Fusarium fujikuroi IMI 58289,https://mycocosm.jgi.doe.gov/Fusfu1,2,4,7,13,11,3,7,47
Fusarium graminearum Z3639 v2.0,https://mycocosm.jgi.doe.gov/Fusgra2,0,1,6,9,13,2,4,35
Fusarium graminearum v1.0,https://mycocosm.jgi.doe.gov/Fusgr1,0,1,9,11,8,3,5,37
Fusarium langsethiae Fl201059,https://mycocosm.jgi.doe.gov/Fusla1,1,0,9,10,10,3,7,40
Fusarium mangiferae MRC7560,https://mycocosm.jgi.doe.gov/Fusma1,4,3,10,12,11,2,7,49
Fusarium oxysporum F10-03 v1.0,https://mycocosm.jgi.doe.gov/FoxF1003_1,6,3,10,14,10,2,7,52
Fusarium oxysporum F10-04 v1.0,https://mycocosm.jgi.doe.gov/FoxF1004_1,4,3,13,14,10,2,7,53
Fusarium oxysporum F10-08 v1.0,https://mycocosm.jgi.doe.gov/FoxF1008_1,4,3,11,15,9,2,7,51
Fusarium oxysporum F10-10 v1.0,https://mycocosm.jgi.doe.gov/FoxF1010_1,6,3,10,14,10,2,8,53
Fusarium oxysporum F2-01 v1.0,https://mycocosm.jgi.doe.gov/FoxF201_1,4,2,12,14,9,2,8,51
Fusarium oxysporum F2-02 v1.0,https://mycocosm.jgi.doe.gov/FoxF202_1,5,4,11,14,9,2,7,52
Fusarium oxysporum F2-04 v1.0,https://mycocosm.jgi.doe.gov/FoxF204_1,4,3,12,14,9,2,7,51
Fusarium oxysporum F2-06 v1.0,https://mycocosm.jgi.doe.gov/FoxF206_1,5,3,11,14,9,2,8,52
Fusarium oxysporum F2-07 v1.0,https://mycocosm.jgi.doe.gov/FoxF207_1,4,2,11,14,8,2,8,49
Fusarium oxysporum Fo47,https://mycocosm.jgi.doe.gov/FusoxFo47,4,3,9,13,8,4,8,49
Fusarium oxysporum Fo47 v2.0,https://mycocosm.jgi.doe.gov/FusoxFo47_2,4,3,9,14,9,3,7,49
Fusarium oxysporum Fo5176 v1.0,https://mycocosm.jgi.doe.gov/FoxFo5176,3,3,6,15,6,2,8,43
Fusarium oxysporum MPI-CAGE-CH-0212 v1.0,https://mycocosm.jgi.doe.gov/Fusoxys1,3,3,9,12,10,2,6,45
Fusarium oxysporum MPI-SDFR-AT-0094 v1.0,https://mycocosm.jgi.doe.gov/Fusoxy1,3,3,10,13,8,3,8,48
Fusarium oxysporum MRL8996 v1.0,https://mycocosm.jgi.doe.gov/FoxMRL8996,3,3,9,12,8,3,9,47
Fusarium oxysporum NRRL 26365,https://mycocosm.jgi.doe.gov/Fox26365_1,4,3,6,12,8,2,7,42
Fusarium oxysporum NRRL 32931,https://mycocosm.jgi.doe.gov/Fusox32931,5,3,8,11,10,3,9,49
Fusarium oxysporum f. sp. albedinis isolate 9 v1.0,https://mycocosm.jgi.doe.gov/Fusoxalb1,3,3,8,11,12,3,5,45
Fusarium oxysporum f. sp. conglutinans race 2 54008 (PHW808),https://mycocosm.jgi.doe.gov/Fusoxcon1,3,4,9,14,8,2,9,49
Fusarium oxysporum f. sp. cubense tropical race 4 54006 (II5),https://mycocosm.jgi.doe.gov/Fusoxcub1,4,3,6,12,10,3,7,45
Fusarium oxysporum f. sp. lycopersici 4287 v2,https://mycocosm.jgi.doe.gov/Fusox2,3,2,9,14,10,1,7,46
Fusarium oxysporum f. sp. lycopersici MN25 (FoMN25) NRRL 54003,https://mycocosm.jgi.doe.gov/Fusoxlyc1,5,3,8,13,8,4,7,48
Fusarium oxysporum f. sp. matthiolae PHW726,https://mycocosm.jgi.doe.gov/FoxPHW726_1,5,3,7,11,10,2,7,45
Fusarium oxysporum f. sp. melonis (FoMelon) NRRL 26406,https://mycocosm.jgi.doe.gov/Fusoxmel1,4,3,9,14,10,2,8,50
Fusarium oxysporum f. sp. pisi HDV247,https://mycocosm.jgi.doe.gov/Fusoxpis1,3,4,9,13,8,2,8,47
Fusarium oxysporum f. sp. pisi T415 v1.0,https://mycocosm.jgi.doe.gov/FusoxT415,2,5,8,13,7,2,8,45
Fusarium oxysporum f. sp. radicis-lycopersici 26381 (CL57),https://mycocosm.jgi.doe.gov/Fusoxrad1,3,3,8,13,8,2,8,45
Fusarium oxysporum f. sp. raphani 54005,https://mycocosm.jgi.doe.gov/Fusoxrap1,3,4,7,13,6,2,9,44
Fusarium oxysporum f. sp. vasinfectum 25433 (Cotton),https://mycocosm.jgi.doe.gov/Fusoxvas1,3,3,7,14,8,2,8,45
Fusarium oxysporum f.sp. cubense II5 v2.0,https://mycocosm.jgi.doe.gov/FoxII5,4,3,6,12,9,3,7,44
Fusarium poae 2516,https://mycocosm.jgi.doe.gov/Fuspo1,0,2,4,12,10,2,12,42
Fusarium proliferatum ET1,https://mycocosm.jgi.doe.gov/Fuspro1,3,4,9,15,13,2,10,56
Fusarium pseudograminearum CS3096,https://mycocosm.jgi.doe.gov/Fusps1,0,1,7,10,6,4,5,33
Fusarium redolens MPI-CAGE-AT-0023 v1.0,https://mycocosm.jgi.doe.gov/Fusre1,4,3,10,11,13,2,6,49
Fusarium solani FSSC 5 v1.0,https://mycocosm.jgi.doe.gov/Fusso1,2,1,11,8,13,2,1,38
Fusarium sp. FIESC 12 MPI-CAGE-AA-0113 v1.0,https://mycocosm.jgi.doe.gov/Fuseq1,1,1,10,8,9,2,4,35
Fusarium sp. FSSC 11 v1.0,https://mycocosm.jgi.doe.gov/FusspF11_1,2,1,8,7,12,2,1,33
Fusarium tricinctum MPI-SDFR-AT-0044 v1.0,https://mycocosm.jgi.doe.gov/Fustri1,3,3,11,13,14,3,6,53
Fusarium tricinctum MPI-SDFR-AT-0068 v1.0,https://mycocosm.jgi.doe.gov/Fustr1,4,3,10,13,13,3,5,51
Fusarium vanettenii 77-13-4 v2.0,https://mycocosm.jgi.doe.gov/Necha2,1,1,8,8,11,2,1,32
Fusarium venenatum MPI-CAGE-CH-0201 v1.0,https://mycocosm.jgi.doe.gov/Fusven1,0,2,4,11,8,2,5,32
Fusarium verticillioides 7600 v2,https://mycocosm.jgi.doe.gov/Fusve2,3,3,7,13,11,2,7,46
Gaertneriomyces semiglobifer Barr 43 v1.0,https://mycocosm.jgi.doe.gov/Gaesem1,0,0,1,1,2,1,0,5
Gaeumannomyces graminis var. tritici R3-111a-1,https://mycocosm.jgi.doe.gov/Gaegr1,2,3,5,3,13,2,3,31
Galerina marginata v1.0,https://mycocosm.jgi.doe.gov/Galma1,0,1,1,7,4,2,24,39
Galzinia incrustans CBS 104901 v1.0,https://mycocosm.jgi.doe.gov/Galinc1,0,0,0,4,1,0,2,7
Ganoderma sinense ZZ0214-1,https://mycocosm.jgi.doe.gov/Gansi1,0,0,1,12,4,0,14,31
Ganoderma sp. 10597 SS1 v1.0,https://mycocosm.jgi.doe.gov/Gansp1,0,0,1,11,5,0,12,29
Gautieria morchelliformis GMNE.BST v1.0,https://mycocosm.jgi.doe.gov/Gaumor1_1,7,0,2,15,4,0,17,45
Geastrum triplex GST.BST v1.0,https://mycocosm.jgi.doe.gov/Geatri1,1,0,0,7,3,0,10,21
Gelasinospora tetrasperma v1.0,https://mycocosm.jgi.doe.gov/Gelte1,1,0,4,3,10,2,2,22
Geopyxis carbonaria DOB1671 v1.0,https://mycocosm.jgi.doe.gov/Geocar1,0,0,3,5,7,2,1,18
Geosiphon pyriformis,https://mycocosm.jgi.doe.gov/Geopyr1,0,0,0,1,0,1,0,2
Geranomyces variabilis JEL559 v1.0,https://mycocosm.jgi.doe.gov/Gervar1,0,1,2,4,1,2,0,10
Gigaspora rosea v1.0,https://mycocosm.jgi.doe.gov/Gigro1,0,5,1,8,0,3,2,19
Gilbertella persicaria var. persicaria CBS 190.32-T v1.0,https://mycocosm.jgi.doe.gov/Gilper1,0,0,1,3,1,1,0,6
Glarea lozoyensis ATCC 20868,https://mycocosm.jgi.doe.gov/Glalo1,1,5,4,11,24,2,0,47
Globomyces pollinis-pini Arg68 v1.0,https://mycocosm.jgi.doe.gov/Glopol1,0,0,10,4,1,1,0,16
Gloeopeniophorella convolvens OM19405 v1.0,https://mycocosm.jgi.doe.gov/Glocon1,0,0,0,2,2,0,8,12
Gloeophyllum trabeum v1.0,https://mycocosm.jgi.doe.gov/Glotr1_1,0,0,0,14,6,7,10,37
Glomerella acutata (Colletotrichum fiorinae MH 18) v1.0,https://mycocosm.jgi.doe.gov/Gloac1,5,3,8,9,20,3,9,57
Glomerella cingulata 23 (Colletotrichum gloeosporoides 23) v1.0,https://mycocosm.jgi.doe.gov/Gloci1,8,4,13,13,31,2,12,83
Gloniopsis sp. FL0384 v1.0,https://mycocosm.jgi.doe.gov/Glonio1,1,1,4,6,14,2,5,33
Glonium stellatum CBS 207.34 v1.0,https://mycocosm.jgi.doe.gov/Glost2,1,1,9,5,19,4,2,41
Golovinomyces cichoracearum UCSC1 v1.0,https://mycocosm.jgi.doe.gov/Golci1,0,0,1,3,1,2,0,7
Golovinomyces cichoracearum UMSG1,https://mycocosm.jgi.doe.gov/GciUMSG1_1,0,0,1,3,1,2,0,7
Golovinomyces cichoracearum UMSG3,https://mycocosm.jgi.doe.gov/GciUMSG3_1,0,0,1,3,1,2,0,7
Golovinomyces orontii MGH1 v4.0,https://mycocosm.jgi.doe.gov/Golor4,0,0,2,6,3,4,0,15
Gonapodya prolifera v1.0,https://mycocosm.jgi.doe.gov/Ganpr1,0,0,0,1,0,3,0,4
Gongronella butleri v1.0,https://mycocosm.jgi.doe.gov/Gonbut1,0,0,1,2,1,1,0,5
Gorgonomyces haynaldii MP57 v1.0,https://mycocosm.jgi.doe.gov/Gorhay1,0,0,0,1,1,1,0,3
Graphis scripta CBS 132367,https://mycocosm.jgi.doe.gov/Grascr1,1,1,8,17,21,4,1,53
Gremmeniella abietina DAOM 170367 v1.0,https://mycocosm.jgi.doe.gov/Greabi1,1,1,2,7,8,2,3,24
Gremmeniella abietina DAOM 170408 v1.0,https://mycocosm.jgi.doe.gov/Greab1,0,1,1,7,9,2,3,23
Grifola frondosa 9006-11,https://mycocosm.jgi.doe.gov/Grifr1,1,0,1,11,2,2,7,24
Grosmannia clavigera kw1407,https://mycocosm.jgi.doe.gov/Grocl1,0,1,1,6,11,5,3,27
Guyanagaster necrorhizus MCA 3950 v1.0,https://mycocosm.jgi.doe.gov/Guyne1,0,2,1,8,2,0,10,23
Gymnascella aurantiaca v1.0,https://mycocosm.jgi.doe.gov/Gymau1,2,0,6,2,8,2,2,22
Gymnascella citrina v1.1,https://mycocosm.jgi.doe.gov/Gymci1_1,2,2,7,1,5,2,1,20
Gymnopilus chrysopellus PR-1187 v1.0,https://mycocosm.jgi.doe.gov/Gymch1,1,1,0,7,5,2,13,29
Gymnopilus junonius AH 44721 v1.0,https://mycocosm.jgi.doe.gov/Gymjun1,0,1,0,9,4,0,9,23
Gymnopus androsaceus JB14 v1.0,https://mycocosm.jgi.doe.gov/Gyman1,0,0,9,23,7,1,10,50
Gymnopus earleae GB-263.02 v1.0,https://mycocosm.jgi.doe.gov/Gymear1,2,0,1,19,5,0,13,40
Gymnopus luxurians v1.0,https://mycocosm.jgi.doe.gov/Gymlu1,1,0,3,24,10,0,11,49
Gyrodon lividus BX v1.0,https://mycocosm.jgi.doe.gov/Gyrli1,0,2,2,9,4,0,5,22
Gyromitra esculenta CBS101906 v1.0,https://mycocosm.jgi.doe.gov/Gyresc1,0,0,3,4,2,2,1,12
Gyromitra infula GyrinfSpk-SM18 v1.0,https://mycocosm.jgi.doe.gov/Gyrinf1,0,0,3,4,2,2,1,12
Halteromyces radiatus CBS 162.75 v1.0,https://mycocosm.jgi.doe.gov/Halrad1,0,0,1,1,1,1,0,4
Hanseniaspora guilliermondii UTAD222,https://mycocosm.jgi.doe.gov/Hangu1,0,0,0,1,0,3,0,4
Hanseniaspora nectarophila Y1191 v1.0,https://mycocosm.jgi.doe.gov/Hanne1,0,0,0,1,0,3,0,4
Hanseniaspora opuntiae AWRI3578,https://mycocosm.jgi.doe.gov/Hanop1,0,0,0,1,0,3,0,4
Hanseniaspora osmophila AWRI3579,https://mycocosm.jgi.doe.gov/Hanos1,0,0,0,1,0,3,0,4
Hanseniaspora uvarum AWRI3580,https://mycocosm.jgi.doe.gov/Hanuv1,0,0,0,1,0,3,0,4
Hanseniaspora valbyensis HY1 v2.0,https://mycocosm.jgi.doe.gov/Hanva2,0,0,0,1,0,3,0,4
Hanseniaspora valbyensis NRRL Y-1626 v1.1,https://mycocosm.jgi.doe.gov/Hanva1_1,0,0,0,1,0,3,0,4
Hebeloma brunneifolium PMI1Jessy v2.0,https://mycocosm.jgi.doe.gov/Hebvel2,0,1,1,8,3,7,16,36
Hebeloma cylindrosporum h7 v2.0,https://mycocosm.jgi.doe.gov/Hebcy2,0,0,1,6,3,0,10,20
Helicocarpus griseus UAMH 5409,https://mycocosm.jgi.doe.gov/Helgr1,3,1,5,9,18,2,4,42
Helicostylum pulchrum RSA 2064 v1.0,https://mycocosm.jgi.doe.gov/Helpul1,0,0,1,4,1,1,0,7
Heliocybe sulcata OMC1185 v1.0,https://mycocosm.jgi.doe.gov/Helsul1,0,0,1,15,5,0,8,29
Helotiales sp. P5P66 v1.0,https://mycocosm.jgi.doe.gov/DimP5P66,1,1,3,12,5,3,1,26
Helotiales sp. P8C63 v1.0,https://mycocosm.jgi.doe.gov/NeoP8C63_1,2,0,5,13,5,2,2,29
Hepatospora eriocheir GB1,https://mycocosm.jgi.doe.gov/Heper1,,,,,,,,0
Hericium coralloides FP-101451 v1.0,https://mycocosm.jgi.doe.gov/Hercor1,0,0,0,12,2,1,5,20
Herpotrichia sp. AK1299 v1.0,https://mycocosm.jgi.doe.gov/Herpot1_1,2,2,8,18,22,6,2,60
Herpotrichiellaceae sp. JF2 05-3F Dopey v1.0,https://mycocosm.jgi.doe.gov/HerpoJF2053F_1,1,0,1,4,3,2,0,11
Herpotrichiellaceae sp. JF2 05-7F Lumpy v1.0,https://mycocosm.jgi.doe.gov/HerpoJF057F_1,1,0,1,4,3,3,0,12
Hesseltinella vesiculosa NRRL3301 v2.0,https://mycocosm.jgi.doe.gov/Hesve2finisherSC,0,0,1,2,1,1,0,5
Heterobasidion annosum v2.0,https://mycocosm.jgi.doe.gov/Hetan2,1,0,0,13,3,0,7,24
Heterodoassansia hygrophilae CBS 346.65 v1.0,https://mycocosm.jgi.doe.gov/Hethyg1,0,1,2,4,1,1,0,9
Heterogastridium pycnidioideum ATCC MYA-4631 v1.0,https://mycocosm.jgi.doe.gov/Hetpy1,0,0,0,1,1,0,0,2
Hexagonia nitida CIRM-BRFM 1802 v1.0,https://mycocosm.jgi.doe.gov/Hexnit1,0,0,2,12,6,0,14,34
Hirsutella minnesotensis 3608,https://mycocosm.jgi.doe.gov/Hirmi1,4,4,23,18,23,5,8,85
Histoplasma capsulatum NAm1,https://mycocosm.jgi.doe.gov/Hisca1,0,0,5,4,1,2,1,13
Homolaphlyctis polyrhiza JEL142 v1.0,https://mycocosm.jgi.doe.gov/Hompol1,0,0,1,0,0,1,0,2
Hortaea acidophila CBS 113389 v1.0,https://mycocosm.jgi.doe.gov/Horac1,0,0,1,7,1,2,0,11
Hortaea thailandica CCFEE 6315,https://mycocosm.jgi.doe.gov/Horth1,0,0,3,8,3,2,0,16
Hortaea werneckii EXF-2000 M0 v1.0,https://mycocosm.jgi.doe.gov/Horwer1,1,0,3,17,2,4,0,27
Hyalopycnis blepharistoma ATCC 48560 v1.0,https://mycocosm.jgi.doe.gov/Hyabl1,0,0,0,1,1,0,0,2
Hyaloraphidium curvatum SAG235-1 v1.0,https://mycocosm.jgi.doe.gov/Hyacur1,0,0,0,2,0,4,0,6
Hyaloscypha finlandica PMI_746 v1.0,https://mycocosm.jgi.doe.gov/Hyafin1,1,1,5,10,21,2,2,42
Hydnomerulius pinastri v2.0,https://mycocosm.jgi.doe.gov/Hydpi2,0,3,1,11,3,0,11,29
Hydnopolyporus fimbriatus CBS384.51 v1.0,https://mycocosm.jgi.doe.gov/Hydfim1,0,0,0,9,3,0,6,18
Hydnum rufescens UP504 v2.0,https://mycocosm.jgi.doe.gov/Hydru2,0,0,1,2,1,0,0,4
Hygrophoropsis aurantiaca ATCC 28755 v1.0,https://mycocosm.jgi.doe.gov/Hygaur1,0,1,2,19,8,1,13,44
Hymenopellis radicata IJFM A160 v1.0,https://mycocosm.jgi.doe.gov/Hymrad1,3,0,2,17,6,0,15,43
Hymenoscyphus varicosporoides PMI_453 v1.0,https://mycocosm.jgi.doe.gov/Hymvar1,0,3,5,11,18,3,5,45
Hypholoma sublateritium v1.0,https://mycocosm.jgi.doe.gov/Hypsu1,0,1,1,5,2,0,9,18
Hyphopichia burtonii NRRL Y-1933 v1.0,https://mycocosm.jgi.doe.gov/Hypbu1,0,0,0,1,0,2,0,3
Hypoxylon argillaceum CBS 527.63 v1.0,https://mycocosm.jgi.doe.gov/Hyparg1,3,3,11,24,39,5,7,92
Hypoxylon cercidicola CBS 119009 v1.0,https://mycocosm.jgi.doe.gov/Hypcer1,1,5,4,16,44,3,5,78
Hypoxylon crocopeplum CBS 119004 v1.0,https://mycocosm.jgi.doe.gov/Hypcro1,2,1,2,19,44,3,6,77
Hypoxylon fragiforme CBS 206.31 v2.0,https://mycocosm.jgi.doe.gov/Hypfra2,0,2,3,11,23,3,8,50
Hypoxylon fuscum CBS 119018 v1.0,https://mycocosm.jgi.doe.gov/Hypfus1,5,2,8,13,37,3,7,75
Hypoxylon monticulosum FL0542 v1.0,https://mycocosm.jgi.doe.gov/Hypmon1,4,1,3,13,36,5,7,69
Hypoxylon polyporus FL1289 v1.0,https://mycocosm.jgi.doe.gov/Hyppol1,1,1,3,10,15,3,3,36
Hypoxylon rubiginosum CBS 119005 v1.0,https://mycocosm.jgi.doe.gov/Hyprub1,2,2,5,17,36,3,7,72
Hypoxylon rubiginosum ER1909 v1.0,https://mycocosm.jgi.doe.gov/HyprubER1909_1,3,6,7,16,42,3,11,88
Hypoxylon sp. CI-4A v1.0,https://mycocosm.jgi.doe.gov/HypCI4A_1,1,0,5,11,23,5,8,53
Hypoxylon sp. CO27-5 v1.0,https://mycocosm.jgi.doe.gov/HypCO275_1,3,2,7,10,30,4,7,63
Hypoxylon sp. EC38 v3.0,https://mycocosm.jgi.doe.gov/HypEC38_3,2,2,6,12,31,3,9,65
Hypoxylon sp. FL0543 v1.0,https://mycocosm.jgi.doe.gov/HyFL0543_1,3,0,3,12,24,3,8,53
Hypoxylon sp. FL0890 v1.0,https://mycocosm.jgi.doe.gov/HyFL0890_1,1,4,5,13,24,3,7,57
Hypoxylon sp. FL1150 v1.0,https://mycocosm.jgi.doe.gov/HyFL1150_1,0,0,3,10,29,2,3,47
Hypoxylon sp. FL1284 v2.0,https://mycocosm.jgi.doe.gov/HyFL1284_2,1,2,4,16,31,4,5,63
Hypoxylon sp. FL1857 v1.0,https://mycocosm.jgi.doe.gov/HyFL1857_1,3,2,2,17,33,3,10,70
Hypoxylon sp. NC0597 v1.0,https://mycocosm.jgi.doe.gov/HyNC0597_1,4,1,4,10,25,3,7,54
Hypoxylon sp. NC1633 v2.0,https://mycocosm.jgi.doe.gov/HyNC1633_2,1,2,2,12,35,3,7,62
Hypoxylon submonticulosum NC0708 v2.0,https://mycocosm.jgi.doe.gov/Hypsub2,2,1,3,12,26,4,5,53
Hypoxylon trugodes CBS 135444 v1.0,https://mycocosm.jgi.doe.gov/Hyptru1,4,4,5,13,27,3,6,62
Hypsizygus marmoreus 51987-8,https://mycocosm.jgi.doe.gov/Hypma1,3,1,1,9,4,0,4,22
Hysterangium stoloniferum HS.BST v1.0,https://mycocosm.jgi.doe.gov/Hyssto1,2,1,0,8,4,2,18,35
Hysterium pulicare,https://mycocosm.jgi.doe.gov/Hyspu1_1,0,2,5,5,21,3,2,38
Ilyonectria robusta PMI_751 v1.0,https://mycocosm.jgi.doe.gov/Ilyrob1,2,3,8,14,11,3,4,45
Ilyonectria sp. MPI-CAGE-AT-0026 v1.0,https://mycocosm.jgi.doe.gov/Ilyeu1,2,4,10,18,14,4,3,55
Ilyonectria sp. MPI-CAGE-AT-0134 v1.0,https://mycocosm.jgi.doe.gov/Neora1,1,4,11,18,17,5,4,60
Ilyonectria sp. v1.0,https://mycocosm.jgi.doe.gov/Ilysp1,2,4,9,17,15,4,4,55
Intextomyces contiguus OMC1699 v1.0,https://mycocosm.jgi.doe.gov/Intcon1_1,0,0,1,13,3,1,9,27
Irpex lacteus CCBAS Fr. 238 617/93 v1.0,https://mycocosm.jgi.doe.gov/Irplac1,0,0,0,13,1,0,6,20
Isaria fumosorosea ARSEF 2679,https://mycocosm.jgi.doe.gov/Corfu1,0,6,12,10,4,3,0,35
Issatchenkia orientalis ATCC 32196 v2.0,https://mycocosm.jgi.doe.gov/Issori2,0,0,0,1,0,2,0,3
Issatchenkia orientalis ATCC PTA-6658 v2.0,https://mycocosm.jgi.doe.gov/Isori2,0,0,0,1,0,2,0,3
Issatchenkia orientalis IO21 v1.0,https://mycocosm.jgi.doe.gov/IsorIO21_1,0,0,0,1,0,2,0,3
Issatchenkia orientalis SD108 v2.0,https://mycocosm.jgi.doe.gov/Issorie2,0,0,0,1,0,2,0,3
Jaapia argillacea v1.0,https://mycocosm.jgi.doe.gov/Jaaar1,0,0,0,7,4,0,10,21
Jahnula aquatica CBS 123560 v1.0,https://mycocosm.jgi.doe.gov/Jahaq1,1,1,11,9,18,3,4,47
Jaminaea sp. MCA 5214 v1.0,https://mycocosm.jgi.doe.gov/Jamsp1,1,0,2,4,1,1,0,9
Jimgerdemannia flammicorona AD002,https://mycocosm.jgi.doe.gov/Jimfl_AD_1,0,0,0,2,0,1,0,3
Jimgerdemannia flammicorona GMNB39,https://mycocosm.jgi.doe.gov/Jimfl_GMNB39_1,0,0,0,1,1,1,0,3
Jimgerdemannia lactiflua OSC166217,https://mycocosm.jgi.doe.gov/Jimlac1,0,0,0,3,0,1,0,4
Kalaharituber pfeilii F3 v1.0,https://mycocosm.jgi.doe.gov/Kalpfe1,0,1,1,1,3,2,2,10
Kalmanozyma brasiliensis GHG001,https://mycocosm.jgi.doe.gov/Kalbr1,0,0,1,6,2,0,0,9
Karstenula rhodostoma CBS 690.94 v1.0,https://mycocosm.jgi.doe.gov/Karrh1,1,1,7,6,13,2,4,34
Kazachstania africana CBS 2517,https://mycocosm.jgi.doe.gov/Kazaf1,0,0,0,1,0,2,0,3
Kazachstania naganishii CBS 8797,https://mycocosm.jgi.doe.gov/Kazna1,0,0,0,1,0,2,0,3
Khuskia oryzae ATCC 28132 v1.0,https://mycocosm.jgi.doe.gov/Khuory1,5,2,4,7,24,3,4,49
Kickxella alabastrina RSA 675 v1.0,https://mycocosm.jgi.doe.gov/Kicala1,0,0,0,1,2,2,0,5
Kluyveromyces lactis,https://mycocosm.jgi.doe.gov/Klula1,0,0,0,1,0,2,0,3
Kluyveromyces marxianus DMKU3 1042,https://mycocosm.jgi.doe.gov/Kluma1,0,0,0,1,0,2,0,3
Kluyveromyces marxianus NRRL Y-1190 v1.0,https://mycocosm.jgi.doe.gov/Klumarx1,0,0,0,1,0,1,0,2
Kockovaella imperatae NRRL Y-17943 v1.0,https://mycocosm.jgi.doe.gov/Kocim1,0,0,0,4,0,1,0,5
Kretzschmaria deusta CBS 826.72 v1.0,https://mycocosm.jgi.doe.gov/KdCBS826_1,2,3,11,15,39,5,7,82
Kretzschmaria deusta IL1129 v1.0,https://mycocosm.jgi.doe.gov/Kredeu1,2,5,10,15,40,5,8,85
Kuraishia capsulata CBS 1993,https://mycocosm.jgi.doe.gov/Kurca1,0,0,0,1,0,2,0,3
Kurtia argillacea OMC1749 v1.0,https://mycocosm.jgi.doe.gov/Kurarg1,0,0,5,2,2,1,7,17
Kwoniella pini CBS 10737,https://mycocosm.jgi.doe.gov/Kwopi1,0,0,0,3,0,1,0,4
Laccaria amethystina LaAM-08-1 v2.0,https://mycocosm.jgi.doe.gov/Lacam2,1,0,0,2,3,2,7,15
Laccaria bicolor 81306 v1.0,https://mycocosm.jgi.doe.gov/Lacbi81306_1,,,,,,,,0
Laccaria bicolor CBS 559.96 v1.0,https://mycocosm.jgi.doe.gov/Lacbi55996_1,1,0,0,4,3,1,9,18
Laccaria bicolor CBS 594.89 v1.0,https://mycocosm.jgi.doe.gov/Lacbi59489_1,1,0,1,12,4,1,13,32
Laccaria bicolor Cham3 v1.0,https://mycocosm.jgi.doe.gov/LacbiCham3_1,,,,,,,,0
Laccaria bicolor D101 v1.0,https://mycocosm.jgi.doe.gov/LacbiD101_1,,,,,,,,0
Laccaria bicolor DR170 v1.0,https://mycocosm.jgi.doe.gov/LacbiDR170_1,1,0,0,2,2,1,5,11
Laccaria bicolor N203 v1.0,https://mycocosm.jgi.doe.gov/LacbiN203_1,,,,,,,,0
Laccaria bicolor S238N 93.12 v1.1,https://mycocosm.jgi.doe.gov/Lacbi9312_2,1,0,0,4,3,0,9,17
Laccaria bicolor S238N v1.0,https://mycocosm.jgi.doe.gov/LacbiS238N_1,,,,,,,,0
Laccaria bicolor S238N-H53 v1.0,https://mycocosm.jgi.doe.gov/LacbiH53_1,,,,,,,,0
Laccaria bicolor S238N-H70 v1.0,https://mycocosm.jgi.doe.gov/LacbiH70_1,,,,,,,,0
Laccaria bicolor S238N-H82 v1.0,https://mycocosm.jgi.doe.gov/LacbiH82_1,,,,,,,,0
Laccaria bicolor S238N-H82xH70 v1.0,https://mycocosm.jgi.doe.gov/LacbiH82xH70_1,,,,,,,,0
Laccaria bicolor S238O v1.0,https://mycocosm.jgi.doe.gov/LacbiS238O_1,,,,,,,,0
Laccaria bicolor v2.0,https://mycocosm.jgi.doe.gov/Lacbi2,1,0,0,4,3,1,8,17
Lachancea dasiensis CBS 10888,https://mycocosm.jgi.doe.gov/Lacda1,0,0,0,1,0,2,0,3
Lachancea fermentati INRA UMR 1319,https://mycocosm.jgi.doe.gov/Lacfe1,0,0,0,1,0,3,0,4
Lachancea lanzarotensis CBS 12615,https://mycocosm.jgi.doe.gov/Lacla1,0,0,0,1,0,3,0,4
Lachancea meyersii CBS 8951,https://mycocosm.jgi.doe.gov/Lacme1,0,0,0,1,0,3,0,4
Lachancea mirantina INRA UMR 1319,https://mycocosm.jgi.doe.gov/Lacmi1,0,0,0,1,0,3,0,4
Lachancea nothofagi CBS 11611,https://mycocosm.jgi.doe.gov/Lacno1,0,0,0,1,0,3,0,4
Lachancea quebecensis INRA UMR 1319,https://mycocosm.jgi.doe.gov/Lacqu1,0,0,0,1,0,3,0,4
Lachancea sp. CBS6924,https://mycocosm.jgi.doe.gov/LacCBS6924_1,0,0,0,1,0,3,0,4
Lachancea thermotolerans CBS 6340,https://mycocosm.jgi.doe.gov/Lacth1,0,0,0,1,0,3,0,4
Lachnellula subtilissima CBS 196.66 v1.0,https://mycocosm.jgi.doe.gov/Lacsu1,1,2,6,9,16,2,2,38
Lactarius akahatsu QP v1.0,https://mycocosm.jgi.doe.gov/Lacaka1,0,0,0,2,2,0,16,20
Lactarius deliciosus 48 v1.0,https://mycocosm.jgi.doe.gov/Lacdel1,0,0,0,2,2,0,18,22
Lactarius hatsudake 109 v1.0,https://mycocosm.jgi.doe.gov/Lachat1,0,0,0,2,2,0,14,18
Lactarius hengduanensis 84 v1.0,https://mycocosm.jgi.doe.gov/Lachen1,0,0,0,2,2,0,11,15
Lactarius indigo 2018DUKE089 v1.0,https://mycocosm.jgi.doe.gov/Lacind1,0,0,0,3,2,0,15,20
Lactarius psammicola BPL869 v1.0,https://mycocosm.jgi.doe.gov/Lacpsa1,0,0,0,2,2,0,12,16
Lactarius pseudohatsudake 88 v1.0,https://mycocosm.jgi.doe.gov/Lacpse1,0,0,0,2,2,0,20,24
Lactarius quietus S23C v1.0,https://mycocosm.jgi.doe.gov/Lacqui1,0,0,0,2,2,0,9,13
Lactarius sanguifluus B21 v1.0,https://mycocosm.jgi.doe.gov/Lacsan1,0,0,0,3,2,0,13,18
Lactarius vividus 141 v1.0,https://mycocosm.jgi.doe.gov/Lacviv1,0,0,0,2,2,0,12,16
Lactifluus cf. subvellereus BPL653 v1.0,https://mycocosm.jgi.doe.gov/Lacsub1,0,0,0,2,2,0,6,10
Lactifluus cf. volemus BPL652 v1.0,https://mycocosm.jgi.doe.gov/Lacvol1,0,0,0,2,2,0,7,11
Laetiporus sulphureus var. sulphureus v1.0,https://mycocosm.jgi.doe.gov/Laesu1,1,0,0,9,7,0,10,27
Lasiosphaeria miniovina SMH2392-1A v1.0,https://mycocosm.jgi.doe.gov/Lasmin1,1,3,4,7,19,3,2,39
Lasiosphaeria ovina CBS 958.72 v1.0,https://mycocosm.jgi.doe.gov/Lasov1,1,3,5,4,22,2,2,39
Lasiosphaeriaceae sp. AZ0830 v1.0,https://mycocosm.jgi.doe.gov/Bombar1,1,3,8,7,17,2,8,46
Lasiosphaeris hirsuta SMH4607-1 v1.0,https://mycocosm.jgi.doe.gov/Lashir1,1,2,7,4,10,3,7,34
Lasiosphaeris hispida CBS 955.72 v1.0,https://mycocosm.jgi.doe.gov/Lashi1,0,2,6,4,13,2,8,35
Laxitextum bicolor CBS 258.73 v1.0,https://mycocosm.jgi.doe.gov/Laxbic1,0,0,0,9,1,1,5,16
Lecanicillium lecanii RCEF 1005,https://mycocosm.jgi.doe.gov/Corco1,0,3,13,8,6,4,0,34
Lecythophora sp. AK0013 v1.0,https://mycocosm.jgi.doe.gov/LecAK0013_1,0,0,5,3,12,2,3,25
Leiotrametes lactinea CIRM-BRFM 1664 v1.0,https://mycocosm.jgi.doe.gov/Tralac1,0,0,1,10,4,0,9,24
Leiotrametes menziesii CIRM-BRFM 1781 v1.0,https://mycocosm.jgi.doe.gov/Tramen1,0,0,1,10,2,1,13,27
Leiotrametes sp BRFM 1775 v1.0,https://mycocosm.jgi.doe.gov/Leisp1,0,0,1,9,4,0,12,26
Lentamyces parricidus NRRL2409 v1.0,https://mycocosm.jgi.doe.gov/Lenpar1,0,0,0,6,1,1,0,8
Lentamyces zychae NRRL 2806 v1.0,https://mycocosm.jgi.doe.gov/Lenzyc1,0,0,0,4,1,1,0,6
Lentinellus vulpinus AHS73672-sp v1.0,https://mycocosm.jgi.doe.gov/Lenvul1,0,0,0,5,2,0,8,15
Lentinula aciculospora JLM2183 v1.0,https://mycocosm.jgi.doe.gov/LacJLM2183_1,0,0,1,12,4,0,7,24
Lentinula afn. boryana TFB7829 v1.0,https://mycocosm.jgi.doe.gov/LboTFB7829_1,0,0,1,10,6,0,6,23
Lentinula afn. lateritia sp 3 TMI1502 v1.0,https://mycocosm.jgi.doe.gov/Lenafn_TMI1502_1,0,0,2,13,7,0,7,29
Lentinula afn. lateritia sp2 HRB7682 ss15 v1.0,https://mycocosm.jgi.doe.gov/Lenafn1,0,0,2,11,5,0,4,22
Lentinula boryana ET3784 v1.0,https://mycocosm.jgi.doe.gov/LboET3784_1,0,0,1,11,7,0,7,26
Lentinula boryana TFB10291 v1.0,https://mycocosm.jgi.doe.gov/Lbo_TFB10291_1,0,0,1,10,6,0,7,24
Lentinula boryana TFB10292 v1.0,https://mycocosm.jgi.doe.gov/LboTFB10292_1,0,0,1,10,6,0,7,24
Lentinula boryana TFB10827 v1.0,https://mycocosm.jgi.doe.gov/Lbo_TFB10827_1,0,0,0,9,6,0,7,22
Lentinula boryana TFB7810 v1.0,https://mycocosm.jgi.doe.gov/LboTFB7810_1,0,0,1,10,5,1,5,22
Lentinula edodes B17 v1.3,https://mycocosm.jgi.doe.gov/LedB17_3,0,0,2,8,5,0,7,22
Lentinula edodes CS-584 v1.0,https://mycocosm.jgi.doe.gov/Led_CS584_1,0,0,2,13,5,2,8,30
Lentinula edodes Le(Bin) 0899 ss11 v1.0,https://mycocosm.jgi.doe.gov/Lenedo1,0,0,2,13,7,1,6,29
Lentinula edodes NBRC 111202,https://mycocosm.jgi.doe.gov/Lened1,0,0,1,12,4,0,3,20
Lentinula edodes TMI1148 v1.0,https://mycocosm.jgi.doe.gov/LedTMI1148_1,0,0,2,12,5,1,7,27
Lentinula edodes TMI1633 v1.0,https://mycocosm.jgi.doe.gov/LedTMI1633_1,0,0,2,10,6,0,6,24
Lentinula edodes VB361 v1.0,https://mycocosm.jgi.doe.gov/LedVB361_1,0,0,2,14,7,0,5,28
Lentinula edodes W1-26 v1.0,https://mycocosm.jgi.doe.gov/Lentinedodes1,0,0,2,12,5,0,6,25
Lentinula lateritia RHP3577 ss4 v1.0,https://mycocosm.jgi.doe.gov/Lenlat1,0,0,2,10,5,0,6,23
Lentinula lateritia RV95-379 v1.0,https://mycocosm.jgi.doe.gov/LlaRV95_379_1,0,0,2,13,5,0,6,26
Lentinula lateritia TMI1499 v1.0,https://mycocosm.jgi.doe.gov/LlaTMI1499_1,0,0,2,14,7,0,7,30
Lentinula novae-zelandiae ICMP 18003 v1.0,https://mycocosm.jgi.doe.gov/LnoICMP18003A_1,0,0,2,12,5,0,6,25
Lentinula novae-zelandiae TMI-1172 v1.0,https://mycocosm.jgi.doe.gov/Lennov1,0,0,1,12,5,0,7,25
Lentinula raphanica INPA1701G ss19 v1.0,https://mycocosm.jgi.doe.gov/Lenrap1,0,0,1,9,8,0,10,28
Lentinula raphanica INPA1820 v1.0,https://mycocosm.jgi.doe.gov/LraINPA1820_1,0,0,2,10,6,0,8,26
Lentinula raphanica JLM1587 v1.0,https://mycocosm.jgi.doe.gov/LraJLM1587_1,0,0,1,9,5,0,6,21
Lentinula raphanica TFB8682 v1.0,https://mycocosm.jgi.doe.gov/Lenra_T_1,0,0,1,10,4,0,6,21
Lentinula raphanica TFB9207 v1.0,https://mycocosm.jgi.doe.gov/LraTFB9207_1,0,0,1,9,5,0,6,21
Lentinula raphanica TFB9929 ss4 v1.0,https://mycocosm.jgi.doe.gov/Lenrap1_155,0,0,1,10,5,1,5,22
Lentinus tigrinus ALCF2SS1-6 v1.0,https://mycocosm.jgi.doe.gov/Lenti6_1,0,0,1,13,2,0,10,26
Lentinus tigrinus ALCF2SS1-7 v1.0,https://mycocosm.jgi.doe.gov/Lenti7_1,0,0,1,13,2,0,11,27
Lentinus tigrinus v1.0,https://mycocosm.jgi.doe.gov/Sisbr1,0,0,1,13,2,0,10,26
Lentithecium fluviatile v1.0,https://mycocosm.jgi.doe.gov/Lenfl1,3,4,6,10,25,4,1,53
Leotiomycetes sp. MPI-SDFR-AT-0126 v1.0,https://mycocosm.jgi.doe.gov/Phimu1,2,4,7,13,12,3,3,44
Lepidopterella palustris v1.0,https://mycocosm.jgi.doe.gov/Leppa1,2,0,5,5,17,3,1,33
Lepista nuda CBS 247.69 v1.0,https://mycocosm.jgi.doe.gov/Lepnud1,2,0,2,14,6,0,16,40
Leptodontidium sp. MPI-SDFR-AT-0119 v2.0,https://mycocosm.jgi.doe.gov/Lepor2,4,1,10,10,20,6,3,54
Leptodontium sp. PMI_412 v1.0,https://mycocosm.jgi.doe.gov/Leptod1,5,1,11,10,22,4,4,57
Leptoporus mollis OMC1684 v1.0,https://mycocosm.jgi.doe.gov/Lepmol1,0,0,0,9,2,0,10,21
Leptosphaeria maculans,https://mycocosm.jgi.doe.gov/Lepmu1,1,0,5,7,10,3,2,28
Leratiomyces ceres mycota028 v1.0,https://mycocosm.jgi.doe.gov/Lerce1,2,1,1,15,3,0,5,27
Leratiomyces erythrocephalus mycota031 v1.0,https://mycocosm.jgi.doe.gov/Lerer1,2,1,1,15,3,0,7,29
Leucangium carthusianum GMNB180 v1.0,https://mycocosm.jgi.doe.gov/Leuca1,0,0,1,3,1,2,0,7
Leucoagaricus gongylophorus AB2 v1.0,https://mycocosm.jgi.doe.gov/Leugon1,2,0,0,6,3,0,4,15
Leucoagaricus gongylophorus AL2 v1.0,https://mycocosm.jgi.doe.gov/LeugonAL2_1,1,0,0,9,4,0,15,29
Leucoagaricus gongylophorus AS2 v1.0,https://mycocosm.jgi.doe.gov/LeugonAS2_1,2,0,0,5,3,1,7,18
Leucoagaricus gongylophorus Ac12,https://mycocosm.jgi.doe.gov/Leugo1_1,2,0,0,2,1,0,4,9
Leucogyrophana mollusca KUC20120723A-06 v1.0,https://mycocosm.jgi.doe.gov/Leumo1,0,1,3,7,6,0,14,31
Leucosporidiella creatinivora UCDFST 62-1032 v1.0,https://mycocosm.jgi.doe.gov/Leucr1,0,0,1,3,1,0,0,5
Lichtheimia corymbifera JMRC:FSU:9682,https://mycocosm.jgi.doe.gov/Liccor1,0,0,0,5,1,1,0,7
Lichtheimia hyalospora v1.0,https://mycocosm.jgi.doe.gov/Lichy1,0,0,0,6,1,1,0,8
Lichtheimia ramosa JMRC FSU 6197,https://mycocosm.jgi.doe.gov/Licra1,0,0,0,4,1,1,0,6
Linderina pennispora ATCC 12442 v1.0,https://mycocosm.jgi.doe.gov/Linpe1,0,0,1,0,15,3,0,19
Lindgomyces ingoldianus ATCC 200398 v1.0,https://mycocosm.jgi.doe.gov/Linin1,2,3,14,10,29,7,2,67
Lindra thalassiae JK4322 v1.0,https://mycocosm.jgi.doe.gov/Linth1,0,0,2,2,5,2,0,11
Lineolata rhizophorae ATCC 16933 v1.0,https://mycocosm.jgi.doe.gov/Linrh1,1,0,1,1,1,2,0,6
Linnemannia elongata AD073 v1.0,https://mycocosm.jgi.doe.gov/MoeAD073_1,0,0,0,1,1,1,0,3
Lipomyces starkeyi NRRL Y-11557 v1.0,https://mycocosm.jgi.doe.gov/Lipst1_1,0,0,1,2,1,3,0,7
Lizonia empirigonia CBS 542.76 v1.0,https://mycocosm.jgi.doe.gov/Lizem1,0,0,6,8,11,3,0,28
Lobaria pulmonaria Africa extracted metagenome v1.0,https://mycocosm.jgi.doe.gov/LobpulAf1,3,2,10,13,33,2,7,70
Lobaria pulmonaria Scotland extracted metagenome v1.0,https://mycocosm.jgi.doe.gov/LobpulSc1,5,2,9,13,32,3,8,72
Lobaria pulmonaria Scotland reference genome v1.0,https://mycocosm.jgi.doe.gov/Lobpul1,5,4,10,12,35,3,8,77
Lobaria pulmonaria Spain extracted metagenome v1.0,https://mycocosm.jgi.doe.gov/LobpulSp1,5,3,9,12,31,4,6,70
Lobaria pulmonaria Switzerland extracted metagenome v1.0,https://mycocosm.jgi.doe.gov/LobpulSw1,4,3,10,13,32,2,8,72
Lobosporangium transversale NRRL 3116 v1.0,https://mycocosm.jgi.doe.gov/Lobtra1,0,0,1,0,1,1,0,3
Lodderomyces elongisporus NRRL YB-4239,https://mycocosm.jgi.doe.gov/Lodelo1,0,0,0,1,0,2,0,3
Lollipopaia minuta P26; CBS 116597 v1.0,https://mycocosm.jgi.doe.gov/Lolmi1,1,3,3,9,8,3,2,29
Lomentospora prolificans JHH-5317,https://mycocosm.jgi.doe.gov/Lompr1,0,1,4,5,4,2,1,17
Lophiostoma macrostomum v1.0,https://mycocosm.jgi.doe.gov/Lopma1,2,1,4,9,15,2,2,35
Lophiotrema nucula CBS 627.86 v1.0,https://mycocosm.jgi.doe.gov/Lopnu1,1,4,10,7,20,3,4,49
Lophium mytilinum CBS 269.34 v1.0,https://mycocosm.jgi.doe.gov/Lopmy1,2,0,4,4,7,3,2,22
Lophodermium nitens PLMe3-1-3 v1.0,https://mycocosm.jgi.doe.gov/Lopnit1_1,6,1,11,18,30,2,1,69
Lophodermium piceae NOR1-14_p44 v1.0,https://mycocosm.jgi.doe.gov/Loppic1,4,2,11,20,51,5,3,96
Loramyces juncicola 46458 v1.0,https://mycocosm.jgi.doe.gov/Lorju1,3,4,7,14,18,3,2,51
Loramyces macrosporus CBS235.53 v1.0,https://mycocosm.jgi.doe.gov/Lorma1,3,2,6,13,20,3,3,50
Lunasporangiospora selenospora KOD1015 v1.0,https://mycocosm.jgi.doe.gov/Morsel1,0,0,2,1,1,1,0,5
Lycoperdon perlatum FP-102459-T v1.0,https://mycocosm.jgi.doe.gov/Lycper1,1,0,0,7,4,0,7,19
Lyophyllum atratum CBS 144462 v1.0,https://mycocosm.jgi.doe.gov/Lyoat1,2,0,0,9,2,0,5,18
Macrolepiota fuliginosa MF-IS2 v1.0,https://mycocosm.jgi.doe.gov/Macfu1,1,0,0,6,2,0,10,19
Macrophomina phaseolina MPI-SDFR-AT-0080 v1.0,https://mycocosm.jgi.doe.gov/Macpha1,0,4,15,15,27,8,9,78
Macrophomina phaseolina MS6,https://mycocosm.jgi.doe.gov/Macph1,0,3,13,15,20,6,6,63
Macroventuria anomochaeta CBS 525.71 v1.0,https://mycocosm.jgi.doe.gov/Macan1,1,0,3,6,5,2,1,18
Madurella mycetomatis mm55,https://mycocosm.jgi.doe.gov/Madmy1,4,6,8,2,17,4,5,46
Magnaporthe oryzae 70-15 v3.0,https://mycocosm.jgi.doe.gov/Magor1,2,3,7,6,21,3,8,50
Magnaporthiopsis poae ATCC 64411,https://mycocosm.jgi.doe.gov/Magpo1,0,1,4,6,11,4,1,27
Malassezia globosa,https://mycocosm.jgi.doe.gov/Malgl1,0,0,2,1,1,0,0,4
Malassezia pachydermatis CBS 1879,https://mycocosm.jgi.doe.gov/Malpa1,0,0,1,2,2,0,0,5
Malassezia sympodialis ATCC 42132,https://mycocosm.jgi.doe.gov/Malsy1_1,0,0,2,1,1,0,0,4
Malassezia vespertilionis NWHC:44797-103,https://mycocosm.jgi.doe.gov/Malve1,0,0,1,2,1,0,0,4
Marasmius fiardii PR-910 v1.0,https://mycocosm.jgi.doe.gov/Marfi1,1,0,2,16,3,0,15,37
Mariannaea sp. PMI_226 v1.0,https://mycocosm.jgi.doe.gov/MarPMI226,2,0,9,10,15,2,1,39
Marssonina brunnea f. sp. monogermtubi NL1,https://mycocosm.jgi.doe.gov/Mabrmo1,0,1,1,4,6,2,4,18
Marssonina brunnea f. sp. multigermtubi MB_m1,https://mycocosm.jgi.doe.gov/Marbr1,0,1,2,3,6,2,3,17
Martensiomyces pterosporus CBS 209.56 v1.0,https://mycocosm.jgi.doe.gov/Marpt1,0,0,1,0,5,14,0,20
Massarina eburnea CBS 473.64 v1.0,https://mycocosm.jgi.doe.gov/Maseb1,1,2,5,8,12,2,1,31
Massariosphaeria phaeospora CBS 611.86 v1.0,https://mycocosm.jgi.doe.gov/Masph1,2,2,3,7,16,3,1,34
Meira miltonrushii MCA 3882 v1.0,https://mycocosm.jgi.doe.gov/Meimi1,0,0,1,5,0,1,0,7
Melampsora allii-populina 12AY07 v1.0,https://mycocosm.jgi.doe.gov/Melap1finSC_191,0,0,1,2,1,2,0,6
Melampsora americana R15-033-03 v1.0,https://mycocosm.jgi.doe.gov/Melame1,0,0,1,3,1,0,0,5
Melampsora larici-populina v2.0,https://mycocosm.jgi.doe.gov/Mellp2_3,0,0,1,2,1,0,0,4
Melampsora lini CH5,https://mycocosm.jgi.doe.gov/Melli1,0,0,1,2,1,0,0,4
Melampsora medusae f. sp. Deltoidae Mmd05TRE539 v1.0,https://mycocosm.jgi.doe.gov/Melmed1,0,0,0,4,1,0,0,5
Melampsora medusae f. sp. tremuloidae Mmt05Ida529 v1.0,https://mycocosm.jgi.doe.gov/Melme_tre1,0,0,0,4,1,1,0,6
Melampsora x columbiana Clatskanie v1.0,https://mycocosm.jgi.doe.gov/MecolCla_1,0,0,1,6,2,0,0,9
Melanconium sp. NRRL 54901 v1.0,https://mycocosm.jgi.doe.gov/Melsp1,4,2,10,16,45,4,5,86
Melanogaster broomeianus MBLB.BST v1.0,https://mycocosm.jgi.doe.gov/Melbro1,0,2,1,10,9,3,8,33
Melanomma pulvis-pyrius v1.0,https://mycocosm.jgi.doe.gov/Melpu1,2,5,4,7,29,4,2,53
Melanops tulasnei CBS 116805 v1.0,https://mycocosm.jgi.doe.gov/Meltu1,0,0,9,8,13,3,5,38
Melanospora tiffanyae F1KG0001 v1.0,https://mycocosm.jgi.doe.gov/Melti1,0,0,1,5,4,2,1,13
Melanotaenium endogenum CBS481.91 v1.0,https://mycocosm.jgi.doe.gov/Melen1,0,0,2,2,3,1,0,8
Meliniomyces bicolor E v2.0,https://mycocosm.jgi.doe.gov/Melbi2,2,1,6,12,23,2,1,47
Meliniomyces sp. PMI_1271 v1.0,https://mycocosm.jgi.doe.gov/MelPMI1271_1,1,2,5,10,20,2,1,41
Meliniomyces variabilis F v1.0,https://mycocosm.jgi.doe.gov/Melva1,1,0,4,14,17,2,1,39
Meredithblackwellia eburnea MCA 4105 v1.0,https://mycocosm.jgi.doe.gov/Mereb1,0,0,1,3,1,0,0,5
Meripilus sumstinei FP 105329 v1.0,https://mycocosm.jgi.doe.gov/Mersum1,1,0,1,3,2,0,8,15
Metarhizium acridum CQMa 102,https://mycocosm.jgi.doe.gov/Metac1,3,2,11,7,12,4,1,40
Metarhizium album ARSEF 1941,https://mycocosm.jgi.doe.gov/Metal1,3,1,10,6,8,3,0,31
Metarhizium anisopliae ARSEF 549,https://mycocosm.jgi.doe.gov/Metani1,5,4,15,12,19,5,2,62
Metarhizium brunneum ARSEF3297,https://mycocosm.jgi.doe.gov/Metbr1,4,6,13,14,19,4,3,63
Metarhizium guizhouense ARSEF977,https://mycocosm.jgi.doe.gov/Metgui1,6,6,14,15,21,3,3,68
Metarhizium majus ARSEF 297,https://mycocosm.jgi.doe.gov/Metma1,6,5,12,12,17,5,2,59
Metarhizium rileyi RCEF4871,https://mycocosm.jgi.doe.gov/Metri1,1,2,11,6,10,2,0,32
Metarhizium robertsii ARSEF 23,https://mycocosm.jgi.doe.gov/Metro1,5,5,13,13,21,3,3,63
Metschnikowia bicuspidata NRRL YB-4993 v1.0,https://mycocosm.jgi.doe.gov/Metbi1,0,0,0,1,0,2,0,3
Metschnikowia bicuspidata single-cell v1.0,https://mycocosm.jgi.doe.gov/Metbi_SCcomb,0,0,0,1,0,2,0,3
Metschnikowia fructicola 277,https://mycocosm.jgi.doe.gov/Metfru2,0,0,0,2,0,2,0,4
Metschnikowia gruessii VY0332 v1.0,https://mycocosm.jgi.doe.gov/Metgru1,0,0,0,1,0,2,0,3
Metschnikowia pulcherrima NRRL Y-7111 v1.0,https://mycocosm.jgi.doe.gov/Metpul1,0,0,0,1,0,2,0,3
Metschnikowia rancensis CR1 v1.0,https://mycocosm.jgi.doe.gov/Mranc1,0,0,0,1,0,2,0,3
Metschnikowia reukaufii MR1 v1.1,https://mycocosm.jgi.doe.gov/Metreu1,0,0,0,1,0,2,0,3
Metschnikowia sp. yHQL305 v1.0,https://mycocosm.jgi.doe.gov/MetyHQL305_1,0,0,0,1,0,2,0,3
Metschnikowia viticola Y813 v1.0,https://mycocosm.jgi.doe.gov/Metvi1,0,0,0,1,0,2,0,3
Meyerozyma guilliermondii ATCC 6260,https://mycocosm.jgi.doe.gov/Meygui1,0,0,0,1,0,2,0,3
Microascus trigonosporus CBS 218.31 v1.0,https://mycocosm.jgi.doe.gov/Mictr1,1,1,3,7,8,2,1,23
Microbotryomycetes sp. P2C70 v1.0,https://mycocosm.jgi.doe.gov/ObeP2C70,0,0,1,1,1,0,0,3
Microbotryum intermedium 1389 BM 12 12,https://mycocosm.jgi.doe.gov/Micin1,0,0,1,1,1,0,0,3
Microbotryum lychnidis-dioicae p1A1 Lamole,https://mycocosm.jgi.doe.gov/Micld1,0,0,1,1,1,0,0,3
Microdiplodia sp. AK1800 v1.0,https://mycocosm.jgi.doe.gov/Microd1,4,2,8,8,11,4,1,38
Microdochium bolleyi J235TASD1 v1.0,https://mycocosm.jgi.doe.gov/Micbo1,2,4,4,7,11,2,6,36
Microdochium trichocladiopsis MPI-CAGE-CH-0230 v1.0,https://mycocosm.jgi.doe.gov/Mictri1,3,2,4,9,16,2,5,41
Microsporum canis CBS 113480,https://mycocosm.jgi.doe.gov/Micca1,5,5,12,7,11,4,3,47
Microthyrium microscopicum CBS 115976 v1.0,https://mycocosm.jgi.doe.gov/Micmi1,2,0,2,5,7,2,1,19
Mitosporidium daphniae UGP3,https://mycocosm.jgi.doe.gov/Mitdap1,0,0,0,0,0,1,0,1
Mixia osmundae IAM 14324 v1.0,https://mycocosm.jgi.doe.gov/Mixos1,0,0,1,3,1,0,0,5
Moelleriella libera RCEF2490,https://mycocosm.jgi.doe.gov/Moeli1,2,1,3,8,10,2,1,27
Moesziomyces antarcticus JCM 10317,https://mycocosm.jgi.doe.gov/Moean1,0,0,2,5,2,1,0,10
Moesziomyces aphidis DSM 70725,https://mycocosm.jgi.doe.gov/Moeaph1,0,0,2,6,1,2,0,11
Monacrosporium haptotylum CBS 200.50,https://mycocosm.jgi.doe.gov/Monha1,1,1,2,3,3,3,1,14
Monascus purpureus v1.0,https://mycocosm.jgi.doe.gov/Monpu1,0,2,7,5,4,5,0,23
Monascus ruber NRRL 1597 v1.0,https://mycocosm.jgi.doe.gov/Monru1,0,3,7,5,10,3,0,28
Moniliella sp. MCA 3643 v1.0,https://mycocosm.jgi.doe.gov/Monili2,0,0,2,8,3,2,0,15
Moniliophthora perniciosa FA553,https://mycocosm.jgi.doe.gov/Monpe1_1,3,0,0,1,0,1,6,11
Moniliophthora roreri MCA 2997,https://mycocosm.jgi.doe.gov/MroMCA2997_1,3,0,3,9,11,0,14,40
Morchella angusticeps Mel-15 v1.0,https://mycocosm.jgi.doe.gov/Morang1,0,0,1,5,1,2,1,10
Morchella arbutiphila PhC291 v1.0,https://mycocosm.jgi.doe.gov/Morarb1,0,0,1,5,1,2,1,10
Morchella brunnea Mel-22 v1.0,https://mycocosm.jgi.doe.gov/Morbru1,0,0,1,5,1,2,1,10
Morchella conifericola Mel-32 v1.0,https://mycocosm.jgi.doe.gov/Morcon1,0,0,1,5,1,2,1,10
Morchella deliciosa PhC191 v1.0,https://mycocosm.jgi.doe.gov/Mordel1,1,0,1,5,1,2,1,11
Morchella diminutiva Mes-2 v1.0,https://mycocosm.jgi.doe.gov/Mordim1,0,0,1,6,0,2,0,9
Morchella disparilis PhC 293 v1.0,https://mycocosm.jgi.doe.gov/Mordis1,0,0,2,5,0,2,0,9
Morchella eohespera Mel-19 v1.0,https://mycocosm.jgi.doe.gov/Moreoh1,0,0,1,6,0,2,1,10
Morchella fluvialis PhC 265 v3.0,https://mycocosm.jgi.doe.gov/Morfluv1,1,0,1,6,0,2,0,10
Morchella hispaniolensis Mel-18 v1.0,https://mycocosm.jgi.doe.gov/Morhis1,2,0,2,6,0,2,1,13
Morchella importuna CCBAS932 v1.0,https://mycocosm.jgi.doe.gov/Morco1,0,0,1,6,0,2,1,10
Morchella importuna SCYDJ1-A1 v1.0,https://mycocosm.jgi.doe.gov/Morimp1,0,0,1,5,1,2,1,10
Morchella kakiicolor PhC 280 v3.0,https://mycocosm.jgi.doe.gov/Morkaki1,0,0,2,5,0,2,0,9
Morchella palazonii PhC 149 v1.0,https://mycocosm.jgi.doe.gov/Morpal1,1,0,1,6,0,2,1,11
Morchella peruviana NRRL 66754 v1.0,https://mycocosm.jgi.doe.gov/Morper1,1,0,1,6,0,2,0,10
Morchella prava Mes-7 v1.0,https://mycocosm.jgi.doe.gov/Morpra1,1,0,1,5,1,2,0,10
Morchella pulchella Mel-31 v1.0,https://mycocosm.jgi.doe.gov/Morpul1,0,0,1,5,1,2,1,10
Morchella punctipes GB769 v1.0,https://mycocosm.jgi.doe.gov/Morpun1,0,0,1,5,2,2,0,10
Morchella semilibera PhC 218 v1.0,https://mycocosm.jgi.doe.gov/Morsem1,0,0,2,4,1,2,0,9
Morchella snyderi DOB2414 v1.0,https://mycocosm.jgi.doe.gov/Morsny1,0,0,1,6,0,2,1,10
Morchella steppicola PhC 289 v1.0,https://mycocosm.jgi.doe.gov/Morste1,1,0,1,5,1,2,1,11
Morchella vulgaris PhC 271 v2.0,https://mycocosm.jgi.doe.gov/Morvulg1,1,0,1,6,0,2,0,10
Mortierella alpina AD266 v1.0,https://mycocosm.jgi.doe.gov/Moralp1_1,0,0,7,5,1,1,0,14
Mortierella alpina KOD1005 v1.0,https://mycocosm.jgi.doe.gov/Moramoe1,0,0,1,4,1,1,0,7
Mortierella ambigua NRRL 28271 v1.0,https://mycocosm.jgi.doe.gov/Moramb1,0,0,1,1,1,1,0,4
Mortierella capitata AV005 v1.0,https://mycocosm.jgi.doe.gov/Morcap1,0,0,3,1,1,1,0,6
Mortierella elongata AG-77 v2.0,https://mycocosm.jgi.doe.gov/Morel2,0,0,0,3,0,1,0,4
Mortierella elongata MPI-CAGE-AA-0104 v1.0,https://mycocosm.jgi.doe.gov/Morel_U14_1,0,0,0,1,1,1,0,3
Mortierella elongata NVP64 v1.0,https://mycocosm.jgi.doe.gov/MoeNVP64_1,0,0,0,1,1,1,0,3
Mortierella gamsii AM1032 v1.0,https://mycocosm.jgi.doe.gov/Morgam1,0,0,0,2,1,1,0,4
Mortierella humilis PMI_1414 v1.0,https://mycocosm.jgi.doe.gov/Morhum1,0,0,3,2,1,1,1,8
Mortierella minutissima AD051 v1.0,https://mycocosm.jgi.doe.gov/Mormin1_1,0,0,3,3,1,1,0,8
Mortierella multidivaricata RSA 2152 T v1.0,https://mycocosm.jgi.doe.gov/Mormul1,0,0,0,3,1,1,0,5
Mortierella sp. AD185 v1.0,https://mycocosm.jgi.doe.gov/MorAD185_1_1,0,0,37,2,1,1,0,41
Mortierella sp. GBAus27b v1.0,https://mycocosm.jgi.doe.gov/MorGBAus27b_1,0,0,3,13,1,1,0,18
Mortierella verticillata NRRL 6337,https://mycocosm.jgi.doe.gov/Morve1,0,0,4,2,1,1,1,9
Mortierella wolfii NRRL 6351 v1.0,https://mycocosm.jgi.doe.gov/Morwol1,0,0,5,2,1,1,0,9
Mrakia frigida ATCC 22029 v1.0,https://mycocosm.jgi.doe.gov/Mrafri1,0,0,0,2,0,1,0,3
Mucor ambiguus NBRC 6742,https://mycocosm.jgi.doe.gov/Mucam1,0,0,1,2,2,1,0,6
Mucor circinelloides f circinelloides 1006PhL,https://mycocosm.jgi.doe.gov/Muccirc1,0,0,1,4,2,1,0,8
Mucor cordense RSA 1222 v1.0,https://mycocosm.jgi.doe.gov/Kircor1,0,0,1,7,2,1,0,11
Mucor endophyticus,https://mycocosm.jgi.doe.gov/Mucend1,0,0,1,2,1,1,0,5
Mucor fuscus,https://mycocosm.jgi.doe.gov/Mucfus1,0,0,1,0,1,1,0,3
Mucor heterogamus NRRL 1489 v1.0,https://mycocosm.jgi.doe.gov/Zyghet1,0,0,2,3,1,1,0,7
Mucor lanceolatus,https://mycocosm.jgi.doe.gov/Muclan1,0,0,1,0,1,1,0,3
Mucor lusitanicus (circinelloides) MU402 v1.0,https://mycocosm.jgi.doe.gov/Muccir1_3,0,0,1,4,2,1,0,8
Mucor lusitanicus CBS277.49 v2.0,https://mycocosm.jgi.doe.gov/Mucci2,0,0,1,4,2,1,0,8
Mucor mucedo NRRL 3635 v1.0,https://mycocosm.jgi.doe.gov/Mucmuc1,0,0,1,4,1,1,0,7
Mucor racemosus,https://mycocosm.jgi.doe.gov/Mucrac1,0,0,1,2,2,1,0,6
Multifurca ochricompacta BPL690 v1.0,https://mycocosm.jgi.doe.gov/Muloch1,0,0,0,2,2,0,21,25
Mutinus elegans ME.BST v1.0,https://mycocosm.jgi.doe.gov/Mutel1,1,0,8,6,4,1,13,33
Myceliophthora heterothallica CBS 202.75 v1.0,https://mycocosm.jgi.doe.gov/Mychet1,0,2,5,3,11,2,1,24
Myceliophthora heterothallica CBS 203.75 v1.0,https://mycocosm.jgi.doe.gov/Myche1,0,2,4,3,11,3,1,24
Myceliophthora similis CBS 632.67 v1.0,https://mycocosm.jgi.doe.gov/Corsim1,1,2,6,5,21,4,3,42
Myceliophthora thermophila (Sporotrichum thermophile) v2.0,https://mycocosm.jgi.doe.gov/Spoth2,0,2,5,2,11,2,2,24
Mycena albidolilacea CBHHK002 v1.0,https://mycocosm.jgi.doe.gov/Mycalb1,8,2,5,17,18,5,20,75
Mycena alexandri CBHHK200 v1.0,https://mycocosm.jgi.doe.gov/Mycale1,2,2,1,15,5,2,3,30
Mycena amicta BAPX v1.0,https://mycocosm.jgi.doe.gov/Mycami1,0,0,0,14,4,0,8,26
Mycena belliae CBHHK173m v1.0,https://mycocosm.jgi.doe.gov/Mycbel1,0,1,0,15,2,1,7,26
Mycena capillaripes Frankland 9286 v1.0,https://mycocosm.jgi.doe.gov/Mycrub1,5,2,2,20,5,2,33,69
Mycena crocata CBHHK184 v1.0,https://mycocosm.jgi.doe.gov/Myccro1,1,1,2,19,5,1,14,43
Mycena epipterygia CBHHK145m v1.0,https://mycocosm.jgi.doe.gov/Mycepi1,2,2,4,23,9,0,10,50
Mycena filopes CBHHK001 v1.0,https://mycocosm.jgi.doe.gov/Mycfil1,6,3,3,16,6,0,11,45
Mycena floridula CBHHK072 v1.0,https://mycocosm.jgi.doe.gov/Mycflo1,2,0,1,9,6,0,4,22
Mycena galericulata CBHHK162m v1.0,https://mycocosm.jgi.doe.gov/Mycgale1,2,1,2,22,12,1,20,60
Mycena galopus ATCC-62051 v1.0,https://mycocosm.jgi.doe.gov/Mycgal1,9,9,2,18,16,2,26,82
Mycena haematopus CBHHK189 v1.0,https://mycocosm.jgi.doe.gov/Mychae1,1,0,0,15,8,0,7,31
Mycena latifolia 10383 v1.0,https://mycocosm.jgi.doe.gov/Myclat1,4,2,0,30,7,0,18,61
Mycena leptocephala CBHHK5/15 v1.0,https://mycocosm.jgi.doe.gov/Myclep1,4,2,3,33,17,3,31,93
Mycena maculata CBHHK188m v1.0,https://mycocosm.jgi.doe.gov/Mycmac1,2,2,2,13,7,0,11,37
Mycena metata CBHHK182m v1.0,https://mycocosm.jgi.doe.gov/Mycmet1,1,2,3,24,8,1,15,54
Mycena olivaceomarginata CBHHK47/15 v1.0,https://mycocosm.jgi.doe.gov/Mycoli1,12,1,4,32,34,4,40,127
Mycena polygramma CBHHK137 v1.0,https://mycocosm.jgi.doe.gov/Mycpol1,3,3,3,30,20,2,24,85
Mycena pura 9144 v1.0,https://mycocosm.jgi.doe.gov/Mycpur1,3,2,0,24,11,3,16,59
Mycena rebaudengoi CBHHK068 v1.0,https://mycocosm.jgi.doe.gov/Mycreb1,5,4,1,22,14,3,45,94
Mycena rosella CBHHK067 v1.0,https://mycocosm.jgi.doe.gov/Mycros1,2,1,2,19,8,0,11,43
Mycena sanguinolenta CBHHK176m v1.0,https://mycocosm.jgi.doe.gov/Mycsan1,3,1,5,22,10,2,30,73
Mycena sp. CBHHK59/15 v1.0,https://mycocosm.jgi.doe.gov/Myc59_1,1,2,2,19,5,0,4,33
Mycena vitilis CBHHK169m v1.0,https://mycocosm.jgi.doe.gov/Mycvit1,4,0,2,18,15,0,10,49
Mycena vulgaris CBHHK164 v1.0,https://mycocosm.jgi.doe.gov/Mycvul1,2,1,2,33,10,1,34,83
Mycosphaerella eumusae CBS 114824,https://mycocosm.jgi.doe.gov/Myceu1,0,2,5,8,10,2,1,28
Mycosphaerella graminicola v2.0,https://mycocosm.jgi.doe.gov/Mycgr3,0,0,5,9,11,2,1,28
Mycotypha africana NRRL 2978 v1.0,https://mycocosm.jgi.doe.gov/Mycafr1,0,0,1,1,2,1,0,5
Mycotypha indica IMI 211999 v1.0,https://mycocosm.jgi.doe.gov/Mycind1,0,0,1,2,2,1,0,6
Myriangiaceae sp. NC1570 v1.0,https://mycocosm.jgi.doe.gov/Myrian1,0,0,11,11,9,3,2,36
Myriangium duriaei CBS 260.36 v1.0,https://mycocosm.jgi.doe.gov/Myrdu1,0,1,9,7,8,2,0,27
Myrothecium inundatum CBS 120646 v1.0,https://mycocosm.jgi.doe.gov/Myrin1,6,3,14,19,37,4,4,87
Mytilinidiaceae sp. NC0267 v1.0,https://mycocosm.jgi.doe.gov/Lophiu1,1,1,4,5,5,2,1,19
Mytilinidion resinicola CBS 304.34 v1.0,https://mycocosm.jgi.doe.gov/Mytre1,1,0,7,4,15,4,1,32
Myxozyma melibiosi Phaff 52-87 v1.0,https://mycocosm.jgi.doe.gov/Myxme1,0,0,1,2,0,2,0,5
Nadsonia fulvescens var. elongata DSM 6958 v1.0,https://mycocosm.jgi.doe.gov/Nadfu1,0,0,1,0,0,2,0,3
Naematelia encephela UCDFST 68-887.2 v1.0,https://mycocosm.jgi.doe.gov/Treen1,0,0,0,2,0,1,0,3
Naganishia vishniacii ANT03-052 v1.0,https://mycocosm.jgi.doe.gov/Cryvi1,0,0,0,3,1,0,0,4
Naganishia vishniacii ANT03-052 v1.1,https://mycocosm.jgi.doe.gov/Nagvi1,0,0,0,3,1,0,0,4
Naiadella fluitans ATCC 64713 v1.0,https://mycocosm.jgi.doe.gov/Naifl1,0,0,1,5,1,0,0,7
Nakaseomyces bacillisporus CBS 7720,https://mycocosm.jgi.doe.gov/Nakbac1,0,0,0,1,0,2,0,3
Nakaseomyces delphensis CBS 2170,https://mycocosm.jgi.doe.gov/Nakdel1,0,0,0,1,0,2,0,3
Nakazawaea wickerhamii NRRL Y-2563,https://mycocosm.jgi.doe.gov/Nakwi1,0,0,0,1,0,2,0,3
Nannizzia gypsea CBS 118893,https://mycocosm.jgi.doe.gov/Nangy1,4,5,10,8,12,3,2,44
Naohidea sebacea CBS 8477 (P95) v1.0,https://mycocosm.jgi.doe.gov/Naose1,0,0,1,2,1,0,0,4
Naumovozyma castellii CBS 4309,https://mycocosm.jgi.doe.gov/Nauca1,0,0,0,1,0,2,0,3
Naumovozyma dairenensis CBS 421,https://mycocosm.jgi.doe.gov/Nauda1,0,0,0,1,0,2,0,3
Nectriopsis sporangicola NRRL 22127 v1.0,https://mycocosm.jgi.doe.gov/Necsp1,1,0,1,6,5,1,1,15
Nemania abortiva FL1152 v1.0,https://mycocosm.jgi.doe.gov/Nemabo1,5,2,7,22,56,6,12,110
Nemania diffusa NC0034 v1.0,https://mycocosm.jgi.doe.gov/Nemdif1,4,5,12,25,39,6,6,97
Nemania serpens AK0226 v1.0,https://mycocosm.jgi.doe.gov/NsAK0226_1,2,3,9,11,29,4,6,64
Nemania serpens AZ0576 v1.0,https://mycocosm.jgi.doe.gov/NsAZ0576_1,7,2,9,19,46,3,9,95
Nemania serpens CBS 679.86 v1.0,https://mycocosm.jgi.doe.gov/NsCB679_1,8,4,9,16,40,3,9,89
Nemania sp. FL0031 v2.0,https://mycocosm.jgi.doe.gov/NeFL0031_2,4,7,8,17,48,4,11,99
Nemania sp. FL0916 v1.0,https://mycocosm.jgi.doe.gov/NeFL0916_1,5,9,10,15,45,5,8,97
Nemania sp. NC0429 v1.0,https://mycocosm.jgi.doe.gov/Nemani1,5,2,11,15,33,3,5,74
Nematocida displodere JUm2807,https://mycocosm.jgi.doe.gov/Nemdi1,,,,,,,,0
Nematocida parisii ERTm1,https://mycocosm.jgi.doe.gov/Nempa1,,,,,,,,0
Neocallimastix californiae G1 v1.0,https://mycocosm.jgi.doe.gov/Neosp1,0,0,10,6,14,9,0,39
Neocallimastix lanati v1.0,https://mycocosm.jgi.doe.gov/Neolan1,0,0,9,8,15,10,0,42
Neocallimastix sp. Gf-Ma3-1 v1.0,https://mycocosm.jgi.doe.gov/NeoGfMa1,0,1,20,9,14,13,0,57
Neocallimastix sp. WI3-B v1.0,https://mycocosm.jgi.doe.gov/NeoWI3_1,0,1,15,7,13,13,0,49
Neocosmospora boninensis NRRL 22470 v1.0,https://mycocosm.jgi.doe.gov/Neobo1,2,0,9,8,17,2,2,40
Neofusicoccum parvum UCRNP2,https://mycocosm.jgi.doe.gov/Neopa1,0,3,10,9,16,5,6,49
Neolecta irregularis DAH-1 v1.0,https://mycocosm.jgi.doe.gov/Neoirr1,0,0,1,1,0,2,3,7
Neolentinus lepideus v1.0,https://mycocosm.jgi.doe.gov/Neole1,0,0,2,18,4,0,11,35
Neonectria ditissima R09/05,https://mycocosm.jgi.doe.gov/Neodi1,1,2,8,11,14,2,3,41
Neosartorya fischeri NRRL 181,https://mycocosm.jgi.doe.gov/Neofi1,7,1,14,10,15,2,1,50
Neurospora crassa FGSC 73 trp-3 v1.0,https://mycocosm.jgi.doe.gov/Neucr_trp3_1,1,0,3,3,7,2,0,16
Neurospora crassa FGSC4200 (ORS6A) v2.0,https://mycocosm.jgi.doe.gov/Ncrass2,1,0,3,3,7,2,0,16
Neurospora crassa OR74A v2.0,https://mycocosm.jgi.doe.gov/Neucr2,1,0,3,3,7,2,0,16
Neurospora crassa clade B FGSC 4830 v1.0,https://mycocosm.jgi.doe.gov/Neucr4830_1,1,0,3,3,6,2,0,15
Neurospora discreta FGSC 8579 mat A,https://mycocosm.jgi.doe.gov/Neudi1,1,0,3,2,7,2,0,15
Neurospora hispaniola FGSC 10403 v1.0,https://mycocosm.jgi.doe.gov/Neuhi1,1,0,3,3,7,2,0,16
Neurospora tetrasperma FGSC 2508 mat A v2.0,https://mycocosm.jgi.doe.gov/Neute_matA2,1,0,3,3,7,2,0,16
Neurospora tetrasperma FGSC 2509 mat a v1.0,https://mycocosm.jgi.doe.gov/Neute_mat_a1,1,0,3,3,7,2,0,16
Nia vibrissa CBS 119815 v1.0,https://mycocosm.jgi.doe.gov/Niavib1,1,0,1,2,1,0,3,8
Niesslia exilis CBS 358.70 v1.0,https://mycocosm.jgi.doe.gov/Nieex1,3,3,16,16,25,2,0,65
Nosema apis BRL 01,https://mycocosm.jgi.doe.gov/Nosap1,,,,,,,,0
Nosema bombycis CQ1,https://mycocosm.jgi.doe.gov/Nosbo1,,,,,,,,0
Nosema ceranae BRL01,https://mycocosm.jgi.doe.gov/Nosce1,,,,,,,,0
Obba rivulosa 3A-2 v1.0,https://mycocosm.jgi.doe.gov/Obbri1,0,1,1,6,3,0,9,20
Obelidium mucronatum JEL802 v1.0,https://mycocosm.jgi.doe.gov/Obemuc1,0,1,4,2,1,2,0,10
Ogataea parapolymorpha DL-1,https://mycocosm.jgi.doe.gov/Ogapa1,0,0,0,1,0,2,0,3
Ogataea polymorpha NCYC 495 leu1.1 v2.0,https://mycocosm.jgi.doe.gov/Hanpo2,0,0,0,1,0,2,0,3
Oidiodendron maius Zn v1.0,https://mycocosm.jgi.doe.gov/Oidma1,2,4,5,14,34,4,2,65
Oidium neolycopersici UMSG2,https://mycocosm.jgi.doe.gov/Oidneo1,0,0,1,3,1,2,0,7
Oliveonia pauxilla MPI-PUGE-AT-0066 v1.0,https://mycocosm.jgi.doe.gov/Olipa1,3,1,1,3,2,0,2,12
Olpidium bornovanus UBC F19785,https://mycocosm.jgi.doe.gov/Olpbor1,0,0,0,1,0,1,0,2
Omphalotus olearius,https://mycocosm.jgi.doe.gov/Ompol1,0,1,1,15,4,0,6,27
Onnia scaura P-53A v1.0,https://mycocosm.jgi.doe.gov/Onnsc1,0,2,1,5,3,2,11,24
Ophiobolus disseminans CBS 113818 v1.0,https://mycocosm.jgi.doe.gov/Ophdi1,2,4,6,8,10,3,6,39
Ophiocordyceps australis Map64,https://mycocosm.jgi.doe.gov/Ophau1,1,2,9,9,15,3,0,39
Ophiocordyceps camponoti-rufipedis Map16,https://mycocosm.jgi.doe.gov/Ophca1,3,1,5,9,11,4,1,34
Ophiocordyceps kimflemingae SC16a,https://mycocosm.jgi.doe.gov/Ophun1,2,2,4,7,12,3,1,31
Ophiocordyceps sinensis IOZ07,https://mycocosm.jgi.doe.gov/Ophsi1,2,1,7,13,13,3,4,43
Ophiostoma novo-ulmi subsp. novo-ulmi H327,https://mycocosm.jgi.doe.gov/Ophnu1,0,0,1,3,8,2,1,15
Ophiostoma piceae UAMH 11346,https://mycocosm.jgi.doe.gov/Ophpic1,0,0,1,4,8,2,1,16
Ophiostoma piliferum,https://mycocosm.jgi.doe.gov/Ophpi1,0,0,1,1,2,3,1,8
Ophiostoma sp. PMI_507 v1.0,https://mycocosm.jgi.doe.gov/OphPMI507_1,0,0,2,8,10,2,1,23
Ordospora colligata OC4,https://mycocosm.jgi.doe.gov/Ordco1,,,,,,,,0
Orpinomyces sp.,https://mycocosm.jgi.doe.gov/Orpsp1_1,0,0,97,49,2,7,0,155
Oudemansiella mucida CBS 558.79 v1.0,https://mycocosm.jgi.doe.gov/Oudmuc1,1,0,1,21,3,0,12,38
Pachysolen tannophilus NRRL Y-2460 v1.2,https://mycocosm.jgi.doe.gov/Pacta1_2,0,0,0,1,0,2,0,3
Paecilomyces niveus CO7 v1.0,https://mycocosm.jgi.doe.gov/Bysni1,1,7,7,13,19,2,1,50
Paecilomyces variotii CBS 101075 v1.0,https://mycocosm.jgi.doe.gov/Paevar1,0,3,5,8,6,2,3,27
Paecilomyces variotii CBS144490 HYG1 v1.0,https://mycocosm.jgi.doe.gov/Paevar_HGY_1,0,3,7,7,6,2,3,28
Panaeolus papilionaceus CIRM-BRFM 715 v1.0,https://mycocosm.jgi.doe.gov/Panpap1,1,1,1,5,4,0,8,20
Panellus stipticus KUC8834 v1.1,https://mycocosm.jgi.doe.gov/Panst_KUC8834_1_1,0,1,1,8,6,1,5,22
Panellus stipticus LUM v1.0,https://mycocosm.jgi.doe.gov/Panst_LUM_1_1,0,2,0,8,8,0,5,23
Panus rudis PR-1116 ss-1 v1.0,https://mycocosm.jgi.doe.gov/Panru1,0,0,1,6,2,0,10,19
Papiliotrema laurentii 5307AH v1.0,https://mycocosm.jgi.doe.gov/Papla1,0,0,0,3,0,1,0,4
Paracoccidioides brasiliensis Pb03,https://mycocosm.jgi.doe.gov/Parbr1,0,0,4,5,3,2,1,15
Paracoccidioides brasiliensis Pb18,https://mycocosm.jgi.doe.gov/Parbra1,0,0,3,6,3,2,1,15
Paracoccidioides lutzii Pb01,https://mycocosm.jgi.doe.gov/Parlu1,0,0,3,6,3,2,1,15
Paraconiothyrium sporulosum AP3s5-JAC2a v1.0,https://mycocosm.jgi.doe.gov/Parsp1,4,1,4,10,17,2,2,40
Paramicrosporidium saccamoebae KSL3,https://mycocosm.jgi.doe.gov/Parsa1,0,0,0,0,1,1,0,2
Paraphoma chrysanthemicola MPI-GEGE-AT-0034 v1.0,https://mycocosm.jgi.doe.gov/Parch1,0,3,3,8,7,3,4,28
Paraphoma chrysanthemicola MPI-SDFR-AT-0120 v1.0,https://mycocosm.jgi.doe.gov/Parchr1,0,2,4,11,10,2,1,30
Paraphysoderma sedebokerense JEL821 v1.0,https://mycocosm.jgi.doe.gov/Parsed1,0,0,0,1,1,1,0,3
Parasitella parasitica v1.0,https://mycocosm.jgi.doe.gov/Parpar1,0,0,1,2,2,1,0,6
Parauncinula polyspora,https://mycocosm.jgi.doe.gov/Parpo1,0,0,1,2,1,2,0,6
Patellaria atrata v1.0,https://mycocosm.jgi.doe.gov/Patat1,0,0,5,4,6,2,0,17
Paxillus adelphus Ve08.2h10 v2.0,https://mycocosm.jgi.doe.gov/Paxru2,0,2,1,6,2,0,5,16
Paxillus ammoniavirescens Pou09.2 v1.0,https://mycocosm.jgi.doe.gov/Paxam1,0,2,1,12,4,0,4,23
Paxillus involutus ATCC 200175 v1.0,https://mycocosm.jgi.doe.gov/Paxin1,0,0,2,13,5,3,6,29
Pecoramyces sp. F1,https://mycocosm.jgi.doe.gov/Pecora1,0,0,40,20,8,9,0,77
Penicillium antarcticum DTO 356-E5 v1.0,https://mycocosm.jgi.doe.gov/Penanta1,4,1,13,9,18,3,4,52
Penicillium antarcticum IBT 31811,https://mycocosm.jgi.doe.gov/Penant1,2,1,13,8,18,2,2,46
Penicillium arizonense CBS 141311,https://mycocosm.jgi.doe.gov/Penar1,3,1,14,11,26,2,1,58
Penicillium atramentosum RS17 v1.0,https://mycocosm.jgi.doe.gov/Penatra1,1,3,10,14,13,2,3,46
Penicillium bilaiae ATCC 20851 v1.0,https://mycocosm.jgi.doe.gov/Penbi1,2,3,8,23,18,2,2,58
Penicillium brasilianum MG11,https://mycocosm.jgi.doe.gov/Penbra1,2,1,11,12,16,2,1,45
Penicillium brevicompactum 1011305 v2.0,https://mycocosm.jgi.doe.gov/Penbr2,2,1,13,16,22,2,4,60
Penicillium brevicompactum AgRF18 v1.0,https://mycocosm.jgi.doe.gov/PenbrAgRF18_1,2,1,15,15,24,2,3,62
Penicillium camemberti FM 013,https://mycocosm.jgi.doe.gov/Pencam1,3,4,15,9,19,2,6,58
Penicillium canescens ATCC 10419 v1.0,https://mycocosm.jgi.doe.gov/Penca1,2,2,14,10,26,3,5,62
Penicillium chrysogenum Wisconsin 54-1255,https://mycocosm.jgi.doe.gov/PenchWisc1_1,1,2,7,15,18,3,3,49
Penicillium chrysogenum v1.0,https://mycocosm.jgi.doe.gov/Pench1,0,2,9,14,18,3,4,50
Penicillium coprophilum IBT 31321,https://mycocosm.jgi.doe.gov/Pencop1,5,2,12,13,20,2,1,55
Penicillium decumbens IBT 11843,https://mycocosm.jgi.doe.gov/Pendec1,1,2,4,5,8,1,1,22
Penicillium digitatum PHI26,https://mycocosm.jgi.doe.gov/Pendi1,1,3,10,9,10,2,3,38
Penicillium digitatum Pd1,https://mycocosm.jgi.doe.gov/Pendig1,1,2,11,8,9,3,3,37
Penicillium expansum ATCC 24692 v1.0,https://mycocosm.jgi.doe.gov/Penex1,4,6,15,10,25,4,5,69
Penicillium expansum d1,https://mycocosm.jgi.doe.gov/Penexp1,3,6,16,10,21,3,3,62
Penicillium fellutanum ATCC 48694 v1.0,https://mycocosm.jgi.doe.gov/Penfe1,1,1,7,9,12,2,1,33
Penicillium flavigenum IBT 14082,https://mycocosm.jgi.doe.gov/Penfla1,4,2,11,15,18,3,4,57
Penicillium freii DAOM 242723,https://mycocosm.jgi.doe.gov/Penfr1,3,3,21,15,12,3,2,59
Penicillium glabrum DAOM 239074 v1.0,https://mycocosm.jgi.doe.gov/Pengl1,2,3,5,22,21,1,1,55
Penicillium griseofulvum PG3,https://mycocosm.jgi.doe.gov/Pengri1,3,3,10,16,21,4,1,58
Penicillium italicum PHI-1,https://mycocosm.jgi.doe.gov/Penita1,0,3,7,7,19,3,4,43
Penicillium janthinellum ATCC 10455 v1.0,https://mycocosm.jgi.doe.gov/Penja1,2,1,9,10,14,3,4,43
Penicillium lanosocoeruleum ATCC 48919 v1.0,https://mycocosm.jgi.doe.gov/Penla1,3,4,12,13,21,2,6,61
Penicillium malodoratum CBS 490.65 v1.0,https://mycocosm.jgi.doe.gov/Penmal1,0,1,10,14,17,2,3,47
Penicillium nalgiovense FM193,https://mycocosm.jgi.doe.gov/Pennal1,2,1,9,16,12,5,1,46
Penicillium nordicum DAOMC 185683,https://mycocosm.jgi.doe.gov/Pennord1,3,1,19,12,20,3,2,60
Penicillium occitanis CL100,https://mycocosm.jgi.doe.gov/Penoc1,1,1,8,20,25,8,4,67
Penicillium oxalicum 114-2,https://mycocosm.jgi.doe.gov/Penox1,3,4,11,13,5,2,2,40
Penicillium polonicum IBT 4502,https://mycocosm.jgi.doe.gov/Penpol1,4,6,17,17,19,3,2,68
Penicillium raistrickii ATCC 10490 v1.0,https://mycocosm.jgi.doe.gov/Penra1,3,5,13,16,23,3,4,67
Penicillium roqueforti FM164,https://mycocosm.jgi.doe.gov/Penro1,1,2,4,8,13,3,5,36
Penicillium solitum IBT 29525,https://mycocosm.jgi.doe.gov/Pensol1,2,3,12,13,21,4,4,59
Penicillium solitum IBT 30036 v1.0,https://mycocosm.jgi.doe.gov/Pensoli1,2,4,11,12,20,2,5,56
Penicillium sp. DTU1 v1.0,https://mycocosm.jgi.doe.gov/Aspcris1,1,2,13,12,22,2,3,55
Penicillium sp. NC0857 v1.0,https://mycocosm.jgi.doe.gov/ThyNC0857_1,2,0,9,10,14,4,1,40
Penicillium steckii IBT 24891,https://mycocosm.jgi.doe.gov/Penste1,4,3,10,13,11,2,0,43
Penicillium subrubescens FBCC1632 / CBS132785,https://mycocosm.jgi.doe.gov/Pensub1,3,1,11,12,21,3,0,51
Penicillium swiecickii 182 6C1 v1.0,https://mycocosm.jgi.doe.gov/Penswi1,5,3,14,15,32,3,5,77
Penicillium thymicola DAOMC 180753 v1.0,https://mycocosm.jgi.doe.gov/Penth1,2,3,18,17,23,2,5,70
Penicillium vulpinum IBT 29486,https://mycocosm.jgi.doe.gov/Penvul1,3,5,12,11,29,2,5,67
Peniophora sp. CONTA v1.0,https://mycocosm.jgi.doe.gov/Lopni1,1,0,2,9,3,0,9,24
Peniophora sp. v1.0,https://mycocosm.jgi.doe.gov/Ricme1,1,0,2,9,2,1,10,25
Perenniporia subacida PersubVin-SM18 v1.0,https://mycocosm.jgi.doe.gov/Persub1,0,0,3,18,5,0,13,39
Periconia macrospinosa DSE2036 v1.0,https://mycocosm.jgi.doe.gov/Perma1,3,6,16,15,40,10,6,96
Pestalotiopsis fici W106-1,https://mycocosm.jgi.doe.gov/Pesfi1,4,4,10,18,26,6,5,73
Pestalotiopsis sp. NC0098 v1.0,https://mycocosm.jgi.doe.gov/Pestal1,3,4,12,18,21,4,4,66
Peterozyma xylosa NRRL Y-12939,https://mycocosm.jgi.doe.gov/Petxy1,0,0,0,1,0,2,0,3
Peziza echinospora DOB1120 v1.0,https://mycocosm.jgi.doe.gov/Pezech1,0,0,1,2,4,3,0,10
Phaeoacremonium aleophilum UCRPA7,https://mycocosm.jgi.doe.gov/Phaal1,1,1,2,4,6,2,1,17
Phaeoacremonium sp. FL0889 v1.0,https://mycocosm.jgi.doe.gov/PhaeoFL0889_1,1,2,10,12,20,3,3,51
Phaeomoniella chlamydospora UCRPC4,https://mycocosm.jgi.doe.gov/Phach1,0,0,4,6,8,2,0,20
Phaeomoniellales sp. NC0930 v1.0,https://mycocosm.jgi.doe.gov/ClaNC0930_1,0,0,10,11,5,3,0,29
Phaeosolenia platensis CBS 268.64 v1.0,https://mycocosm.jgi.doe.gov/Phapla1,0,1,1,4,4,0,7,17
Phaeosphaeria poagena MPI-PUGE-AT-0046c v1.0,https://mycocosm.jgi.doe.gov/Phapo1,1,1,6,5,15,3,2,33
Phaeosphaeriaceae sp. PMI_808 v1.0,https://mycocosm.jgi.doe.gov/PhaPMI808,2,3,9,11,26,7,4,62
Phakopsora pachyrhizi K8108 v2.0,https://mycocosm.jgi.doe.gov/PhapaK8108,0,0,1,2,1,0,0,4
Phakopsora pachyrhizi MT2006 v1.0,https://mycocosm.jgi.doe.gov/Phapa1,0,0,1,2,1,0,0,4
Phakopsora pachyrhizi UFV02 v2.1,https://mycocosm.jgi.doe.gov/PpacPPUFV02,0,0,0,2,1,0,0,3
Phanerochaete carnosa HHB-10118-Sp v1.0,https://mycocosm.jgi.doe.gov/Phaca1,0,0,7,22,2,0,3,34
Phanerochaete chrysosporium RP-78 v2.2,https://mycocosm.jgi.doe.gov/Phchr2,0,0,1,19,2,0,2,24
Phanerochaete chrysosporium RP-78 v3.0,https://mycocosm.jgi.doe.gov/Phchr3_2,0,0,1,18,2,0,4,25
Phascolomyces articulosus v1.0,https://mycocosm.jgi.doe.gov/Phaart1,0,0,0,7,1,1,0,9
Phellinus ferrugineofuscus SpK3Phefer14 v1.0,https://mycocosm.jgi.doe.gov/Phefer1,0,1,1,5,3,2,6,18
Phellinus igniarius CCBS 575 v1.0,https://mycocosm.jgi.doe.gov/Pheign1_1,0,1,1,3,4,0,15,24
Phellinus noxius FFPRI411160,https://mycocosm.jgi.doe.gov/Pheno1,0,1,1,4,2,0,10,18
Phellinus viticola PhevitSig-SM15 v1.0,https://mycocosm.jgi.doe.gov/Phevit1,0,2,1,6,2,1,8,20
Phellopilus nigrolimitatus SigPhenig9 v1.0,https://mycocosm.jgi.doe.gov/Pheni1,0,2,1,9,2,0,9,23
Phialocephala scopiformis 5WS22E1 v1.0,https://mycocosm.jgi.doe.gov/Phisc1,2,5,5,17,24,3,4,60
Phialocephala subalpina UAMH 11012,https://mycocosm.jgi.doe.gov/Phisu1,0,2,5,19,20,4,5,55
Phialophora attae CBS 131958,https://mycocosm.jgi.doe.gov/Phiatt1,0,0,1,4,3,2,0,10
Phlebia brevispora HHB-7030 SS6 v1.0,https://mycocosm.jgi.doe.gov/Phlbr1,0,0,0,19,8,1,7,35
Phlebia centrifuga FBCC195,https://mycocosm.jgi.doe.gov/Phlcen1,0,0,0,16,1,1,4,22
"Phlebia radiata Fr. (isolate 79, FBCC0043)",https://mycocosm.jgi.doe.gov/Phlrad1,0,0,0,15,3,1,6,25
Phlebia subcretacea OMC74 v1.0,https://mycocosm.jgi.doe.gov/Phlsub1,0,0,1,7,4,0,13,25
Phlebiopsis gigantea v1.0,https://mycocosm.jgi.doe.gov/Phlgi1,0,0,0,18,1,0,4,23
Phlebopus sp. FC_14 v2.0,https://mycocosm.jgi.doe.gov/PhlFC14_2,0,2,1,10,3,0,10,26
Phleogena faginea OMC 1709 v1.0,https://mycocosm.jgi.doe.gov/Phlfa1,0,0,19,4,1,0,0,24
Pholiota alnicola AH 47727 v1.0,https://mycocosm.jgi.doe.gov/Phoaln1,0,2,0,14,2,0,18,36
Pholiota conissans CIRM-BRFM 674 v1.0,https://mycocosm.jgi.doe.gov/Phocon1,1,2,1,14,3,0,9,30
Pholiota molesta CBS 144467 v1.0,https://mycocosm.jgi.doe.gov/Phohig1,2,0,0,14,4,0,10,30
Phoma multirostrata 7a v1.0,https://mycocosm.jgi.doe.gov/Phomu1,1,0,4,7,4,2,0,18
Phoma tracheiphila IPT5 v1.0,https://mycocosm.jgi.doe.gov/Photr1,0,1,4,8,14,2,2,31
Phycomyces blakesleeanus L51 v1.0,https://mycocosm.jgi.doe.gov/Phybl_L51_1,0,0,0,2,1,1,0,4
Phycomyces blakesleeanus NRRL1555 v2.0,https://mycocosm.jgi.doe.gov/Phybl2,0,0,1,2,1,1,0,5
Phycomyces blakesleeanus UBC1 v1.0,https://mycocosm.jgi.doe.gov/Phybla1,0,0,1,1,1,1,0,4
Phycomyces blakesleeanus UBC21 v2.0,https://mycocosm.jgi.doe.gov/PhyblU21_2,0,0,1,3,1,1,0,6
Phycomyces nitens S607 v1.0,https://mycocosm.jgi.doe.gov/PnitS607_1,0,0,1,2,1,1,0,5
Phycomyces nitens S608 v1.0,https://mycocosm.jgi.doe.gov/PnitS608_1,0,0,1,2,1,1,0,5
Phycomyces nitens S609 v1.0,https://mycocosm.jgi.doe.gov/PnitS609_1,0,0,1,2,1,1,0,5
Phyllosticta capitalensis CBS 111638 v2.0,https://mycocosm.jgi.doe.gov/Phcapit2,0,1,3,9,4,2,2,21
Phyllosticta capitalensis CBS 117118 v1.0,https://mycocosm.jgi.doe.gov/Phcap1,0,1,3,9,4,2,1,20
Phyllosticta capitalensis CBS 123374 v1.0,https://mycocosm.jgi.doe.gov/Pcapi1,0,1,3,9,4,2,2,21
Phyllosticta capitalensis CBS 128856 v1.0,https://mycocosm.jgi.doe.gov/Phycap1,0,1,3,9,4,2,2,21
Phyllosticta capitalensis CBS 173.77 v2.0,https://mycocosm.jgi.doe.gov/Phycapi2,0,1,3,9,4,2,2,21
Phyllosticta capitalensis CBS 356.52 v1.0,https://mycocosm.jgi.doe.gov/Phcapi1,0,1,3,9,4,2,2,21
Phyllosticta citriasiana CBS 120426 v2.0,https://mycocosm.jgi.doe.gov/Pcitr2,0,1,4,8,5,2,2,22
Phyllosticta citriasiana CBS 120486 v1.0,https://mycocosm.jgi.doe.gov/Phycit1,0,1,4,8,5,2,1,21
Phyllosticta citriasiana CBS 123371 v2.0,https://mycocosm.jgi.doe.gov/Pcitri2,0,1,4,8,5,2,2,22
Phyllosticta citribraziliensis CBS 100098 v1.0,https://mycocosm.jgi.doe.gov/Phcit1,0,1,3,9,5,2,2,22
Phyllosticta citribraziliensis CPC 17464 v1.0,https://mycocosm.jgi.doe.gov/Pcit17464,0,1,3,10,5,2,2,23
Phyllosticta citricarpa CBS 102373 v1.0,https://mycocosm.jgi.doe.gov/Pcit120373,0,1,3,10,5,2,2,23
Phyllosticta citricarpa CBS 111.20 v1.0,https://mycocosm.jgi.doe.gov/Pcit11120,0,1,3,10,5,2,2,23
Phyllosticta citricarpa CBS 122482 v1.0,https://mycocosm.jgi.doe.gov/Pcit122482,0,1,3,10,5,2,2,23
Phyllosticta citricarpa CBS 122670 v1.0,https://mycocosm.jgi.doe.gov/Pcit122670,0,1,3,9,5,2,2,22
Phyllosticta citricarpa CBS 127454 v1.0,https://mycocosm.jgi.doe.gov/Phycitr1,0,1,4,8,5,2,2,22
Phyllosticta citricarpa CBS 131864 v1.0,https://mycocosm.jgi.doe.gov/Pcit131864,0,1,3,10,5,2,2,23
Phyllosticta citricarpa CBS 141352 v1.0,https://mycocosm.jgi.doe.gov/Pcit141352,0,1,3,10,5,2,2,23
Phyllosticta citricarpa CPC 16586 v1.0,https://mycocosm.jgi.doe.gov/Pcit16586,0,1,3,10,5,2,2,23
Phyllosticta citrichinaensis CBS 129764 v1.0,https://mycocosm.jgi.doe.gov/Pcit129764,0,1,3,9,5,2,2,22
Phyllosticta citrichinaensis CBS 130529 v1.0,https://mycocosm.jgi.doe.gov/Phcitr1,0,1,4,9,5,2,0,21
Phyllosticta paracitricarpa CBS 141357 v1.0,https://mycocosm.jgi.doe.gov/Phy27169,0,1,3,7,5,2,2,20
Phyllosticta paracitricarpa CBS 141358 v1.0,https://mycocosm.jgi.doe.gov/Phypa1,0,1,4,10,5,2,2,24
Phyllosticta sp. CPC 27913 v1.0,https://mycocosm.jgi.doe.gov/Phycpc1,0,1,4,9,5,2,2,23
Pichia kudriavzevii CBS573,https://mycocosm.jgi.doe.gov/Pickud1,0,0,0,1,0,2,0,3
Pichia membranifaciens v2.0,https://mycocosm.jgi.doe.gov/Picme2,0,0,0,1,0,2,0,3
Pichia pastoris,https://mycocosm.jgi.doe.gov/Picpa1,0,0,0,1,0,2,0,3
Piedraia hortae CBS 480.64 v1.1,https://mycocosm.jgi.doe.gov/Pieho1_1,0,0,2,1,2,2,0,7
Pilaira anomala RSA1997 v1.0,https://mycocosm.jgi.doe.gov/Pilano1,0,0,1,3,1,1,0,6
Pilobolus umbonatus NRRL 6349 v1.0,https://mycocosm.jgi.doe.gov/Pilumb1,0,0,1,0,1,1,0,3
Piloderma byssinum 4S31 v1.0,https://mycocosm.jgi.doe.gov/Pilbys1,3,0,0,14,8,0,5,30
Piloderma olivaceum F 1598 v1.0,https://mycocosm.jgi.doe.gov/Pilcr1,3,0,1,12,6,1,5,28
Piloderma sphaerosporum 354 v1.0,https://mycocosm.jgi.doe.gov/Pilsph1,0,0,0,4,2,1,9,16
Piptocephalis cylindrospora RSA 2659 single-cell v3.0,https://mycocosm.jgi.doe.gov/Pipcy3_1,0,0,0,0,0,1,0,1
Piptocephalis tieghemiana RSA 1565 v1.0,https://mycocosm.jgi.doe.gov/Piptie1,0,0,1,0,1,1,0,3
Piriformospora indica DSM 11827 from MPI,https://mycocosm.jgi.doe.gov/Pirin1,0,0,0,2,1,0,1,4
Piromyces finnis v3.0,https://mycocosm.jgi.doe.gov/Pirfi3,0,1,1,1,8,2,0,13
Piromyces sp. E2 v1.0,https://mycocosm.jgi.doe.gov/PirE2_1,0,0,34,18,5,8,0,65
Piromyces sp. UH3-1 v2.0,https://mycocosm.jgi.doe.gov/Piromy_p0_1,0,0,8,2,9,5,0,24
Pisolithus albus SI12 v1.0,https://mycocosm.jgi.doe.gov/Pisalb1,0,1,1,8,1,0,6,17
Pisolithus croceorrhizus ssp. 2 72 v1.0,https://mycocosm.jgi.doe.gov/Pisthe227_1,0,2,1,8,1,0,7,19
Pisolithus croceorrhizus subspA 74A v1.0,https://mycocosm.jgi.doe.gov/Piscro1,0,3,1,10,0,0,7,21
Pisolithus marmoratus ssp. 2 16A v1.0,https://mycocosm.jgi.doe.gov/Pismar1,0,1,2,11,1,0,11,26
Pisolithus microcarpus 441 v2.0,https://mycocosm.jgi.doe.gov/Pismi2,0,2,1,5,1,0,7,16
Pisolithus orientalis OTSU v2.0,https://mycocosm.jgi.doe.gov/Pisori2,0,1,1,5,1,0,7,15
Pisolithus sp. B1 v1.0,https://mycocosm.jgi.doe.gov/Pismi_AB1_1,0,1,1,7,1,0,5,15
Pisolithus thermaeus 11 v1.0,https://mycocosm.jgi.doe.gov/Pisthe1,0,3,1,8,1,0,8,21
Pisolithus tinctorius Marx 270 v2.0,https://mycocosm.jgi.doe.gov/Pisti2,0,2,1,7,1,0,10,21
Plectania melastoma CBS 918.72 v1.0,https://mycocosm.jgi.doe.gov/Plemel1,3,3,7,9,34,2,6,64
Plectosphaerella cucumerina DS2psM2a2 v1.0,https://mycocosm.jgi.doe.gov/Plecu1,1,0,3,8,4,2,2,20
Plectosphaerella cucumerina MPI-SDFR-AT-0117 v2.0,https://mycocosm.jgi.doe.gov/Plecucu2,0,0,3,7,6,2,2,20
Plectosphaerella cucumerina RP01 v1.0,https://mycocosm.jgi.doe.gov/Plecuc1,0,0,3,8,6,2,2,21
Pleomassaria siparia v1.0,https://mycocosm.jgi.doe.gov/Plesi1,2,0,3,5,13,2,1,26
Pleospora avicennia ATCC 66911 v1.0,https://mycocosm.jgi.doe.gov/Pleav1,3,3,4,10,20,2,4,46
Pleosporaceae sp. PMI_138 v1.0,https://mycocosm.jgi.doe.gov/PlePMI138_1,0,4,11,7,10,3,3,38
Pleurotus eryngii ATCC 90797 v1.0,https://mycocosm.jgi.doe.gov/Pleery1,0,0,1,7,2,1,8,19
Pleurotus ostreatus PC15 v2.0,https://mycocosm.jgi.doe.gov/PleosPC15_2,0,0,1,8,2,0,10,21
Pleurotus ostreatus PC9 v1.0,https://mycocosm.jgi.doe.gov/PleosPC9_1,0,0,1,8,2,0,10,21
Plicaturopsis crispa v1.0,https://mycocosm.jgi.doe.gov/Plicr1,0,0,0,12,2,0,5,19
Pluteus cervinus NL-1719 v1.0,https://mycocosm.jgi.doe.gov/Plucer1,0,0,1,6,2,0,6,15
Pneumocystis carinii B80,https://mycocosm.jgi.doe.gov/Pneca1,0,0,0,0,0,1,0,1
Pneumocystis jirovecii RU7,https://mycocosm.jgi.doe.gov/Pnejir1,0,0,0,0,0,1,0,1
Pneumocystis jirovecii+++,https://mycocosm.jgi.doe.gov/Pneji1,0,0,0,0,0,1,0,1
Pochonia chlamydosporia 170,https://mycocosm.jgi.doe.gov/Pocchl1,0,4,14,10,16,3,6,53
Podosordaria jugoyasan CBS 670.77 v1.0,https://mycocosm.jgi.doe.gov/Podjug1,2,3,9,16,28,4,6,68
Podospora anserina S mat+,https://mycocosm.jgi.doe.gov/Podan3,3,2,6,7,14,3,2,37
Podospora anserina mat+ v1.0,https://mycocosm.jgi.doe.gov/Podans1,3,2,6,6,15,3,2,37
Podospora appendiculata CBS 314.62 v1.0,https://mycocosm.jgi.doe.gov/Podap1,0,2,4,8,21,4,3,42
Podospora curvicolla TEP21a v1.0,https://mycocosm.jgi.doe.gov/Podcur1,1,0,5,3,13,2,3,27
Podospora didyma CBS 232.78 v1.0,https://mycocosm.jgi.doe.gov/Poddi1,3,3,7,5,22,3,7,50
Polychaeton citri v1.0,https://mycocosm.jgi.doe.gov/Polci1,1,0,7,9,6,2,0,25
Polychytrium aggregatum JEL109 v1.0,https://mycocosm.jgi.doe.gov/Polagg1_1,0,0,0,73,1,1,0,75
Polyplosphaeria fusca CBS 125425 v1.0,https://mycocosm.jgi.doe.gov/Polfu1,1,0,5,6,15,3,0,30
Polyporus arcularius v1.0,https://mycocosm.jgi.doe.gov/Polar1,0,0,1,14,3,1,7,26
Polyporus brumalis BRFM 1820 v1.0,https://mycocosm.jgi.doe.gov/Polbr1,0,0,1,13,3,1,9,27
Polyporus squamosus CCBS 676 v1.0,https://mycocosm.jgi.doe.gov/Polsqu1,0,0,1,13,5,0,7,26
Polytolypa hystricis UAMH 7299,https://mycocosm.jgi.doe.gov/Polhy1,2,3,4,4,16,3,2,34
Porodaedalea chrysoloma FP-135951 v1.0,https://mycocosm.jgi.doe.gov/Porchr1,0,1,1,7,4,0,16,29
Porodaedalea niemelaei PN71-100-IP13 v1.0,https://mycocosm.jgi.doe.gov/Pornie1_2,0,1,1,5,3,0,16,26
Poronia punctata CBS 180.79 v1.0,https://mycocosm.jgi.doe.gov/Porpun1,1,4,10,15,25,2,6,63
Porpomyces mucidus OMC1666 v1.0,https://mycocosm.jgi.doe.gov/Pormuc1,1,0,1,8,1,0,6,17
Postia placenta MAD 698-R v1.0,https://mycocosm.jgi.doe.gov/Pospl1,1,0,0,6,2,0,11,20
Postia placenta MAD-698-R-SB12 v1.0,https://mycocosm.jgi.doe.gov/PosplRSB12_1,1,0,0,10,7,0,11,29
Postia stiptica OMC1664 v1.0,https://mycocosm.jgi.doe.gov/Possti1,0,0,0,9,8,0,11,28
Powellomyces hirtus BR81 v1.0,https://mycocosm.jgi.doe.gov/Powhir1,0,0,6,2,1,1,0,10
Protomyces inouyei,https://mycocosm.jgi.doe.gov/Proin1,0,0,1,1,0,2,0,4
Protomyces lactucaedebilis 12-1054 v1.0,https://mycocosm.jgi.doe.gov/Prola1,0,0,1,1,0,2,0,4
Pseudocercospora (Mycosphaerella) fijiensis v2.0,https://mycocosm.jgi.doe.gov/Mycfi2,0,1,8,7,6,2,2,26
Pseudocercospora musae CBS 116634,https://mycocosm.jgi.doe.gov/Psemus1,0,0,9,8,7,3,2,29
Pseudocercospora ulei ERN8 v1.0,https://mycocosm.jgi.doe.gov/Pseule1,0,0,3,5,2,2,0,12
Pseudofusicoccum sp. LGMF1611 v1.0,https://mycocosm.jgi.doe.gov/Pse1611_1,0,0,14,14,24,7,6,65
Pseudographis elatina,https://mycocosm.jgi.doe.gov/Pseel1,2,2,6,18,33,5,1,67
Pseudogymnoascus destructans 20631-21,https://mycocosm.jgi.doe.gov/Pseudest1,0,0,3,2,7,2,0,14
Pseudogymnoascus sp. 03VT05,https://mycocosm.jgi.doe.gov/Pse03VT05_1,0,0,5,3,5,3,1,17
Pseudogymnoascus sp. VKM F-103,https://mycocosm.jgi.doe.gov/PseVKM103_1,0,2,8,4,11,2,0,27
Pseudogymnoascus sp. VKM F-3775,https://mycocosm.jgi.doe.gov/PseVKM3775_1,2,1,4,3,15,4,0,29
Pseudogymnoascus sp. VKM F-4246,https://mycocosm.jgi.doe.gov/PseVKM4246_1,0,2,9,4,11,2,0,28
Pseudogymnoascus sp. VKM F-4514,https://mycocosm.jgi.doe.gov/PseVKM4514_1,1,3,6,4,6,1,0,21
Pseudogymnoascus sp. VKM F-4520,https://mycocosm.jgi.doe.gov/PseVKM4520_1,0,3,9,7,15,3,1,38
Pseudogymnoascus verrucosus UAMH 10579,https://mycocosm.jgi.doe.gov/Psever1,0,2,6,4,10,2,1,25
Pseudoidium neolycopersici MF1 v1.0,https://mycocosm.jgi.doe.gov/Psene1,0,0,1,3,1,2,0,7
Pseudoloma neurophilia MK1,https://mycocosm.jgi.doe.gov/Pseneu1,,,,,,,,0
Pseudomassariella vexata CBS 129021 v1.0,https://mycocosm.jgi.doe.gov/Pseve2,2,4,4,8,28,4,4,54
Pseudomicrostroma glucosiphilum gen et sp. nov. MCA 4718 v1.0,https://mycocosm.jgi.doe.gov/Rhodsp1,1,0,1,3,1,0,0,6
Pseudovirgaria hyperparasitica CBS 121739 v1.0,https://mycocosm.jgi.doe.gov/Psehy1,0,5,8,5,11,2,6,37
Pseudozyma antarctica T-34,https://mycocosm.jgi.doe.gov/Psean1_1,0,0,3,6,1,2,0,12
Pseudozyma flocculosa PF-1,https://mycocosm.jgi.doe.gov/Psefl1,0,1,1,5,3,0,0,10
Pseudozyma hubeiensis SY62,https://mycocosm.jgi.doe.gov/Psehu1,0,0,3,5,3,0,0,11
Psilocybe cubensis v1.0,https://mycocosm.jgi.doe.gov/Psicub1_1,0,2,1,6,2,0,12,23
Psilocybe serbica v1.0,https://mycocosm.jgi.doe.gov/Psiser1,0,2,1,9,2,0,13,27
Pterula gracilis CBS309.79 v1.0,https://mycocosm.jgi.doe.gov/Ptegra1,10,0,1,6,2,0,8,27
Puccinia coronata avenae 12NC29,https://mycocosm.jgi.doe.gov/PuccoNC29_1,0,0,2,1,2,0,0,5
Puccinia coronata avenae 12SD80,https://mycocosm.jgi.doe.gov/PuccoSD80_1,0,0,2,1,1,0,0,4
Puccinia graminis f. sp. tritici 21-0 haplotype A,https://mycocosm.jgi.doe.gov/Pgt_201_A1,0,0,1,1,1,0,0,3
Puccinia graminis f. sp. tritici 21-0 haplotype B,https://mycocosm.jgi.doe.gov/Pgt_201_B1,0,0,1,1,1,0,0,3
Puccinia graminis f. sp. tritici Ug99 haplotype A,https://mycocosm.jgi.doe.gov/Pgt_Ug99_A1,0,0,1,1,1,0,0,3
Puccinia graminis f. sp. tritici Ug99 haplotype C,https://mycocosm.jgi.doe.gov/Pgt_Ug99_C1,0,0,1,1,0,2,0,4
Puccinia graminis f. sp. tritici v2.0,https://mycocosm.jgi.doe.gov/Pucgr2,0,0,1,1,2,0,0,4
Puccinia striiformis f. sp. tritici 104 E137 A-,https://mycocosm.jgi.doe.gov/Pucstr1,0,0,2,1,2,0,0,5
Puccinia striiformis f. sp. tritici PST-130,https://mycocosm.jgi.doe.gov/Pucst1,0,0,0,2,1,0,0,3
Puccinia striiformis f. sp. tritici PST-78 v1.0,https://mycocosm.jgi.doe.gov/Pucst_PST78_1,0,0,1,1,1,0,0,3
Puccinia triticina 1-1 BBBD Race 1,https://mycocosm.jgi.doe.gov/Puctr1,0,0,1,1,2,0,0,4
Punctularia strigosozonata v1.0,https://mycocosm.jgi.doe.gov/Punst1,1,0,1,14,4,1,8,29
Purpureocillium lilacinum PLFJ-1,https://mycocosm.jgi.doe.gov/Purli1,1,2,8,10,11,2,1,35
Purpureocillium sp. UdeA0106 v1.0,https://mycocosm.jgi.doe.gov/Pursp1,1,2,9,10,12,2,1,37
Pycnoporellus fulgens PcyfulGre-SM17 v1.0,https://mycocosm.jgi.doe.gov/Pycful1,0,0,0,11,8,1,12,32
Pycnoporus cinnabarinus BRFM 137,https://mycocosm.jgi.doe.gov/Pycci1,0,0,0,8,2,0,9,19
Pycnoporus cinnabarinus CIRM-BRFM 50 v1.0,https://mycocosm.jgi.doe.gov/Pyccin1,0,0,1,9,4,0,9,23
Pycnoporus coccineus BRFM 310 v1.0,https://mycocosm.jgi.doe.gov/Pycco1,0,0,1,13,2,0,7,23
Pycnoporus coccineus CIRM1662,https://mycocosm.jgi.doe.gov/Pycco1662_1,0,0,1,13,2,0,8,24
Pycnoporus puniceus CIRM-BRFM 1868 v1.0,https://mycocosm.jgi.doe.gov/Pycpun1,0,0,1,9,3,0,7,20
Pycnoporus sanguineus BRFM 1264 v1.0,https://mycocosm.jgi.doe.gov/Pycsa1,0,0,1,13,2,0,9,25
Pyrenochaeta inflorescentiae CORFU0001 v1.0,https://mycocosm.jgi.doe.gov/Pyrinf1,0,0,6,10,8,3,1,28
Pyrenochaeta lycopersici MPI-SDFR-AT-0127 v1.0,https://mycocosm.jgi.doe.gov/Pyrly1,2,0,8,7,17,2,3,39
Pyrenochaeta sp. DS3sAY3a v1.0,https://mycocosm.jgi.doe.gov/Pyrsp1,0,0,6,8,7,3,1,25
Pyrenophora teres f. teres,https://mycocosm.jgi.doe.gov/Pyrtt1,1,1,24,11,17,3,1,58
Pyrenophora tritici-repentis,https://mycocosm.jgi.doe.gov/Pyrtr1,0,1,10,10,14,3,1,39
Pyronema confluens CBS100304,https://mycocosm.jgi.doe.gov/Pyrco1,1,0,2,4,1,2,0,10
Pyronema domesticum DOB7353 v1.0,https://mycocosm.jgi.doe.gov/Pyrdom1,1,0,2,4,0,2,0,9
Pyronema omphalodes DOB1672 v1.0,https://mycocosm.jgi.doe.gov/Pyrom1,1,0,1,4,1,3,0,10
Rachicladosporium antarcticum CCFEE 5527,https://mycocosm.jgi.doe.gov/Racan1,0,2,4,10,2,4,1,23
Rachicladosporium sp. CCFEE 5018,https://mycocosm.jgi.doe.gov/Rac5018_1,0,1,4,8,2,3,0,18
Radiomyces spectabilis NRRL 2753 v1.0,https://mycocosm.jgi.doe.gov/Radspe1,0,0,0,3,1,1,0,5
Radulomyces confluens OMC1631 v1.0,https://mycocosm.jgi.doe.gov/Radcon1,7,0,1,10,2,0,8,28
Ramaria rubella (R. acris) UT-36052-T v1.0,https://mycocosm.jgi.doe.gov/Ramac1,2,0,19,25,8,1,6,61
Ramicandelaber brevisporus CBS 109374 v1.0,https://mycocosm.jgi.doe.gov/Rambr1,0,0,0,1,1,1,0,3
Resinicium bicolor OMC78 v1.0,https://mycocosm.jgi.doe.gov/Resbic1,0,0,1,11,3,1,7,23
Rhamphospora nymphaeae CBS 172.38 v1.0,https://mycocosm.jgi.doe.gov/Rhanym2_1,1,0,2,5,1,1,0,10
Rhexocercosporidium sp. MPI-PUGE-AT-0058 v1.0,https://mycocosm.jgi.doe.gov/Rhesp1,2,5,7,11,22,4,3,54
Rhinocladiella mackenziei CBS 650.93,https://mycocosm.jgi.doe.gov/Rhima1,0,0,4,6,8,3,0,21
Rhizina undulata CBS 300.56 v1.0,https://mycocosm.jgi.doe.gov/Rhiund1,0,0,2,5,0,2,1,10
Rhizoclosmatium globosum JEL800 v1.0,https://mycocosm.jgi.doe.gov/Rhihy1,0,0,1,5,2,1,0,9
Rhizoctonia solani AG-1 IB,https://mycocosm.jgi.doe.gov/Rhiso1,0,0,2,3,1,0,6,12
Rhizoctonia solani AG-3 Rhs1AP,https://mycocosm.jgi.doe.gov/Rhisol1,0,0,1,6,0,1,7,15
Rhizoctonia solani AG-8 WAC10335,https://mycocosm.jgi.doe.gov/Rhisola1,0,0,1,2,0,0,3,6
Rhizodiscina lignyota CBS 133067 v1.0,https://mycocosm.jgi.doe.gov/Rhili1,0,2,4,8,10,2,0,26
Rhizophagus cerebriforme DAOM 227022 v1.0,https://mycocosm.jgi.doe.gov/Rhice1_1,0,0,1,1,0,1,0,3
Rhizophagus clarus HR1,https://mycocosm.jgi.doe.gov/Rhicl1,0,0,0,2,0,1,0,3
Rhizophagus diaphanus v1.0,https://mycocosm.jgi.doe.gov/Rhidi1,0,0,1,0,0,1,0,2
Rhizophagus irregularis A1 v1.0,https://mycocosm.jgi.doe.gov/RhiirA1_1,0,0,1,1,0,2,0,4
Rhizophagus irregularis A4 v1.0,https://mycocosm.jgi.doe.gov/RhiirA4,0,0,1,0,0,2,0,3
Rhizophagus irregularis A5 v1.0,https://mycocosm.jgi.doe.gov/RhiirA5,0,0,1,0,0,1,0,2
Rhizophagus irregularis B3 v1.0,https://mycocosm.jgi.doe.gov/RhiirB3,0,0,1,0,0,2,0,3
Rhizophagus irregularis C2 v1.0,https://mycocosm.jgi.doe.gov/RhiirC2,0,0,1,1,0,2,0,4
Rhizophagus irregularis DAOM 181602 v1.0,https://mycocosm.jgi.doe.gov/Gloin1,0,0,1,0,0,1,0,2
Rhizophagus irregularis DAOM 197198 v2.0,https://mycocosm.jgi.doe.gov/Rhiir2_1,0,0,1,1,0,1,0,3
Rhizopogon salebrosus TDB-379 v1.0,https://mycocosm.jgi.doe.gov/Rhisa1,0,0,0,7,2,0,14,23
Rhizopogon truncatus FC74 v1.0,https://mycocosm.jgi.doe.gov/Rhitru1,0,0,0,21,2,0,12,35
Rhizopogon vesiculosus Smith,https://mycocosm.jgi.doe.gov/Rhives1,0,0,1,9,3,0,11,24
Rhizopogon vinicolor AM-OR11-026 v1.0,https://mycocosm.jgi.doe.gov/Rhivi1,0,0,1,20,2,0,13,36
Rhizopogon vulgaris FC72 v1.0,https://mycocosm.jgi.doe.gov/Rhivul1,0,0,1,9,1,0,8,19
Rhizopus delemar 99-880 from Broad,https://mycocosm.jgi.doe.gov/Rhior3,0,0,1,6,1,1,0,9
Rhizopus microsporus ATCC11559 v1.0,https://mycocosm.jgi.doe.gov/Rhimi_ATCC11559_1,0,0,1,3,1,1,0,6
Rhizopus microsporus var. chinensis CCTCC M201021,https://mycocosm.jgi.doe.gov/Rhich1,0,0,2,6,1,2,0,11
Rhizopus microsporus var. microsporus ATCC52813 v1.0,https://mycocosm.jgi.doe.gov/Rhimi1_1,0,0,1,3,1,1,0,6
Rhizopus microsporus var. microsporus ATCC52814 v1.0,https://mycocosm.jgi.doe.gov/Rhimi_ATCC52814_1,0,0,1,3,1,1,0,6
Rhizoscyphus ericae UAMH 7357 v1.0,https://mycocosm.jgi.doe.gov/Rhier1,1,1,2,8,10,2,2,26
Rhodocollybia butyracea AH 40177 v1.0,https://mycocosm.jgi.doe.gov/Rhobut1_1,2,0,2,20,5,3,29,61
Rhodocollybia butyracea CCBAS 279 v1.0,https://mycocosm.jgi.doe.gov/Rhobu1,3,0,2,19,7,3,28,62
Rhodofomes roseus CIRM-BRFM 1785 v1.0,https://mycocosm.jgi.doe.gov/Fomros1,1,0,0,9,8,1,10,29
Rhodosporidium diobovatum 08-225 v1.0,https://mycocosm.jgi.doe.gov/Rhodia1_1,0,0,1,2,1,0,0,4
Rhodosporidium glutinis ATCC 204091 v1.0,https://mycocosm.jgi.doe.gov/Rhoglu91_1,0,0,1,1,1,0,0,3
Rhodosporidium toruloides ATCC26217 v1.0,https://mycocosm.jgi.doe.gov/Rhoto_ATCC26217_1,0,0,1,1,1,0,0,3
Rhodosporidium toruloides IFO0559_1,https://mycocosm.jgi.doe.gov/Rhoto_IFO0559_1,0,0,1,1,1,0,0,3
Rhodosporidium toruloides IFO0880 v2.0,https://mycocosm.jgi.doe.gov/Rhoto_IFO0880_2,0,0,1,1,1,0,0,3
Rhodosporidium toruloides IFO0880 v4.0,https://mycocosm.jgi.doe.gov/Rhoto_IFO0880_4,0,0,1,1,1,0,0,3
Rhodosporidium toruloides IFO1236_1,https://mycocosm.jgi.doe.gov/Rhoto_IFO1236_1,0,0,1,1,1,0,0,3
Rhodosporidium toruloides NP11,https://mycocosm.jgi.doe.gov/Rhoto1,0,0,1,1,1,0,0,3
Rhodotorula glutinis v1.0,https://mycocosm.jgi.doe.gov/Rhoglu1,0,0,1,1,1,0,0,3
Rhodotorula graminis strain WP1 v1.1,https://mycocosm.jgi.doe.gov/Rhoba1_1,0,0,2,1,1,0,0,4
Rhodotorula mucilaginosa ATCC58901 v1.0,https://mycocosm.jgi.doe.gov/Rhomuc1,0,0,1,1,0,1,0,3
Rhodotorula mucilaginosa J31 v1.0,https://mycocosm.jgi.doe.gov/RhodotJ31_1,0,0,1,1,1,0,0,3
Rhodotorula sp. CCFEE 5036,https://mycocosm.jgi.doe.gov/RhoCCFEE5036_1,0,0,1,1,1,0,0,3
Rhodotorula sp. JG-1b,https://mycocosm.jgi.doe.gov/Rhosp1,0,0,1,1,1,0,0,3
Rhodotorula taiwanensis MD1149,https://mycocosm.jgi.doe.gov/Rhota1,0,0,1,1,1,0,0,3
Rhynchosporium agropyri 04CH RACA61,https://mycocosm.jgi.doe.gov/Rhyag1,2,2,4,9,9,2,1,29
Rhynchosporium commune UK7,https://mycocosm.jgi.doe.gov/Rhyco1,3,3,4,10,9,2,2,33
Rhynchosporium secalis 02CH4 6a1,https://mycocosm.jgi.doe.gov/Rhyse1,3,2,4,10,9,2,2,32
Rhytidhysteron rufulum,https://mycocosm.jgi.doe.gov/Rhyru1_1,1,5,11,10,28,4,5,64
Rickenella fibula HBK330-10 v1.0,https://mycocosm.jgi.doe.gov/Ricfib1,0,0,3,2,3,1,8,17
Rickenella mellea v1.0 (SZMC22713),https://mycocosm.jgi.doe.gov/Ricmel1,0,1,3,3,5,0,7,19
Rigidoporus microporus ED310 v1.0,https://mycocosm.jgi.doe.gov/Rigmic1,0,0,1,1,1,0,11,14
Roridomyces roridus 9284 v1.0,https://mycocosm.jgi.doe.gov/Rorror1,1,2,1,27,11,3,8,53
Rosellinia corticium 1501 v1.0,https://mycocosm.jgi.doe.gov/Roscor1,1,5,4,13,23,2,5,53
Rosellinia necatrix W97,https://mycocosm.jgi.doe.gov/Rosne1,3,8,7,15,24,6,9,72
Rostrohypoxylon terebratum CBS 119137 v1.0,https://mycocosm.jgi.doe.gov/Roster1,2,1,3,9,28,3,8,54
Rozella allomycis CSF55,https://mycocosm.jgi.doe.gov/Rozal1_1,0,0,0,0,0,1,0,1
Rozella allomycis CSF55 single-cell v1.0,https://mycocosm.jgi.doe.gov/Rozal_SC1,0,0,0,0,0,1,0,1
Russula brevipes BPL707 v1.0,https://mycocosm.jgi.doe.gov/Rusbre1,0,0,0,2,2,0,8,12
Russula compacta BPL669 v1.0,https://mycocosm.jgi.doe.gov/Ruscom1,0,0,1,2,2,0,9,14
Russula dissimulans BPL704 v1.0,https://mycocosm.jgi.doe.gov/Rusdis1,0,0,0,2,1,1,5,9
Russula earlei BPL698 v1.0,https://mycocosm.jgi.doe.gov/Rusear1,0,0,0,2,2,1,7,12
Russula emetica Přilba v1.0,https://mycocosm.jgi.doe.gov/Ruseme1,0,0,0,3,2,0,6,11
Russula ochroleuca Přilba v1.0,https://mycocosm.jgi.doe.gov/Rusoch1,0,0,0,2,2,0,6,10
Russula rugulosa BPL654 v1.0,https://mycocosm.jgi.doe.gov/Rusrug1,0,0,0,2,1,0,7,10
Russula seminuda PSC4341-TAS1 v1.0,https://mycocosm.jgi.doe.gov/Russem1,0,0,0,4,2,0,5,11
Russula vinacea BPL710 v1.0,https://mycocosm.jgi.doe.gov/Rusvin1,0,0,0,3,2,0,6,11
Rutstroemia firma CBS 115.86 v1.0,https://mycocosm.jgi.doe.gov/Rutfi1,1,0,4,18,26,4,2,55
Saccharata proteae CBS 121410 v1.0,https://mycocosm.jgi.doe.gov/Sacpr1,0,1,2,10,3,2,1,19
Saccharomyces arboricola H-6,https://mycocosm.jgi.doe.gov/Sacarb1,0,0,0,1,0,2,0,3
Saccharomyces boulardii unique28,https://mycocosm.jgi.doe.gov/Sacboulardii_1,0,0,0,1,0,2,0,3
Saccharomyces cerevisiae M3707 Dikaryon,https://mycocosm.jgi.doe.gov/SacceM3707_1,0,0,0,1,0,2,0,3
Saccharomyces cerevisiae M3836 v1.0,https://mycocosm.jgi.doe.gov/SacceM3836_1,0,0,0,1,0,2,0,3
Saccharomyces cerevisiae M3837 v1.0,https://mycocosm.jgi.doe.gov/SacceM3837_1,0,0,0,1,0,2,0,3
Saccharomyces cerevisiae M3838 v1.0,https://mycocosm.jgi.doe.gov/SacceM3838_1,0,0,0,1,0,2,0,3
Saccharomyces cerevisiae M3839 v1.0,https://mycocosm.jgi.doe.gov/SacceM3839_1,0,0,0,1,0,2,0,3
Saccharomyces cerevisiae S288C,https://mycocosm.jgi.doe.gov/Sacce1,0,0,0,1,0,2,0,3
Saccharomyces cerevisiae YB210 v1.0,https://mycocosm.jgi.doe.gov/SacceYB210_1,0,0,0,1,0,2,0,3
Saccharomyces eubayanus FM1318,https://mycocosm.jgi.doe.gov/Saceu1,0,0,0,1,0,2,0,3
Saccharomycetaceae sp Ashbya aceri,https://mycocosm.jgi.doe.gov/SacAshbya_1,0,0,0,1,0,2,0,3
Saccharomycopsis capsularis NRRL Y-17639,https://mycocosm.jgi.doe.gov/Sacca1,0,0,0,1,0,2,0,3
Saitoella complicata NRRL Y-17804 v1.0,https://mycocosm.jgi.doe.gov/Saico1,0,0,1,2,0,2,0,5
Saksenaea vasiformis B4078,https://mycocosm.jgi.doe.gov/Sakvas1,0,0,1,1,1,0,0,3
Sarcoscypha coccinea ATCC 58028 v1.0,https://mycocosm.jgi.doe.gov/Sarco1,1,1,1,4,18,2,3,30
Sarocladium strictum UNK v1.0,https://mycocosm.jgi.doe.gov/Sarstr1,1,2,2,12,11,3,3,34
Saturnispora dispora NRRL Y-1447,https://mycocosm.jgi.doe.gov/Satdi1,0,0,0,1,0,2,0,3
Scedosporium apiospermum IHEM 14462,https://mycocosm.jgi.doe.gov/Sceap1,2,4,6,5,10,2,2,31
Scheffersomyces coipomoensis NRRL Y-17651T v1.0,https://mycocosm.jgi.doe.gov/Schcoi1,0,0,0,1,0,2,0,3
Scheffersomyces illinoisensis NRRL Y-48827T v1.0,https://mycocosm.jgi.doe.gov/Schill1,0,0,0,1,0,2,0,3
Scheffersomyces queiroziae UFMG-CLM-5.1 v1.0,https://mycocosm.jgi.doe.gov/Schque1,0,0,0,1,0,2,0,3
Scheffersomyces segobiensis NRRL Y-11571T v1.0,https://mycocosm.jgi.doe.gov/Schseg1_1,0,0,0,1,0,2,0,3
Scheffersomyces stipitis NRRL Y-11545 v2.0,https://mycocosm.jgi.doe.gov/Picst3,0,0,0,1,0,2,0,3
Scheffersomyces stipitis NRRL Y-7124 v1.0,https://mycocosm.jgi.doe.gov/Schsti1,0,0,0,1,0,2,0,3
Scheffersomyces virginianus NRRL Y-48822T v1.0,https://mycocosm.jgi.doe.gov/Schvir1,0,0,0,1,0,2,0,3
Schizophyllum commune 207.1 v1.0,https://mycocosm.jgi.doe.gov/Schco2071_1,1,0,4,8,1,0,3,17
Schizophyllum commune 223.1 v1.0,https://mycocosm.jgi.doe.gov/Schco2231_1,1,0,4,7,1,0,3,16
Schizophyllum commune 225.1 v1.0,https://mycocosm.jgi.doe.gov/Schco2251_1,1,0,4,7,1,0,3,16
Schizophyllum commune 227.1 v1.0,https://mycocosm.jgi.doe.gov/Schco2271_1,1,0,5,7,1,0,3,17
Schizophyllum commune 227.2 v1.0,https://mycocosm.jgi.doe.gov/Schco2272_1,1,0,5,8,1,0,3,18
Schizophyllum commune H4-8 v3.0,https://mycocosm.jgi.doe.gov/Schco3,1,0,5,6,2,0,3,17
Schizophyllum commune Loenen D v1.0,https://mycocosm.jgi.doe.gov/Schco_LoeD_1,1,0,5,9,2,0,3,20
Schizophyllum commune Tattone D v1.0,https://mycocosm.jgi.doe.gov/Schco_TatD_1,1,0,4,7,2,0,3,17
Schizophyllum commune ZB1 v1.0,https://mycocosm.jgi.doe.gov/SchcoZB1,1,0,4,7,1,0,3,16
Schizophyllum commune ZB2 v1.0,https://mycocosm.jgi.doe.gov/SchcoZB2,1,0,4,9,1,0,2,17
Schizophyllum radiatum CBS 301.32 v1.0,https://mycocosm.jgi.doe.gov/Schrad1,1,0,5,14,2,1,3,26
Schizopora paradoxa KUC8140 v1.0,https://mycocosm.jgi.doe.gov/Schpa1,0,0,1,9,2,0,10,22
Schizosaccharomyces cryophilus OY26,https://mycocosm.jgi.doe.gov/Schcy1,0,0,1,4,0,2,0,7
Schizosaccharomyces japonicus yFS275,https://mycocosm.jgi.doe.gov/Schja1,0,0,1,2,0,2,0,5
Schizosaccharomyces octosporus yFS286,https://mycocosm.jgi.doe.gov/Schoc1,0,0,1,2,0,2,0,5
Schizosaccharomyces pombe,https://mycocosm.jgi.doe.gov/Schpo1,0,0,1,2,0,2,0,5
Schizothecium vesticola SMH3187-1 v1.0,https://mycocosm.jgi.doe.gov/Schves1,1,2,5,2,11,2,5,28
Scleroderma citrinum Foug A v1.0,https://mycocosm.jgi.doe.gov/Sclci1,0,1,0,7,1,0,5,14
Scleroderma citrinum hr. v1.0,https://mycocosm.jgi.doe.gov/Sclcihr1,0,1,0,9,1,0,4,15
Sclerogaster hysterangioides SCL2.BST v1.0,https://mycocosm.jgi.doe.gov/Sclhys1_1,1,0,2,10,3,3,10,29
Sclerophora sanguinea CBS100924 v1.0,https://mycocosm.jgi.doe.gov/Sclsan1,0,0,3,5,3,2,0,13
Sclerotinia borealis F4128,https://mycocosm.jgi.doe.gov/Sclbo1,0,0,6,8,12,2,0,28
Sclerotinia sclerotiorum v1.0,https://mycocosm.jgi.doe.gov/Sclsc1,1,1,5,10,15,2,0,34
Scytinostroma sp. KUC9335 v1.0,https://mycocosm.jgi.doe.gov/Scysp1_1,0,0,1,9,7,2,9,28
Sebacina vermifera MAFF 305830 v1.0,https://mycocosm.jgi.doe.gov/Sebve1,0,0,0,1,1,0,1,3
Septobasidium sp. PNB30-8B v1.0,https://mycocosm.jgi.doe.gov/Sepsp1,0,0,2,2,1,0,0,5
Septoria musiva SO2202 v1.0,https://mycocosm.jgi.doe.gov/Sepmu1,0,2,7,8,9,2,2,30
Septoria populicola v1.0,https://mycocosm.jgi.doe.gov/Seppo1,0,0,8,7,9,2,3,29
Serendipita sp. 407 v1.0,https://mycocosm.jgi.doe.gov/Serend1,0,0,0,1,1,0,1,3
Serendipita vermifera ssp. bescii NFPB0129 v1.0,https://mycocosm.jgi.doe.gov/Sebvebe1,0,0,0,1,1,0,1,3
Serpula himantioides (S.lacrymans var shastensis) MUCL38935 v1.0,https://mycocosm.jgi.doe.gov/Serla_varsha1,2,2,8,15,7,1,7,42
Serpula lacrymans S7.3 v2.0,https://mycocosm.jgi.doe.gov/SerlaS7_3_2,1,0,9,10,3,5,10,38
Serpula lacrymans S7.9 v2.0,https://mycocosm.jgi.doe.gov/SerlaS7_9_2,2,2,8,15,6,1,8,42
Serpulomyces borealis OMC1750 v1.0,https://mycocosm.jgi.doe.gov/Serbor1,0,0,4,11,3,0,17,35
Setomelanomma holmii CBS 110217 v1.0,https://mycocosm.jgi.doe.gov/Setho1,1,0,6,7,7,3,2,26
Setosphaeria turcica Et28A v2.0,https://mycocosm.jgi.doe.gov/Settu3,2,2,8,9,22,5,1,49
Setosphaeria turcica NY001 v2.0,https://mycocosm.jgi.doe.gov/Settur3,2,1,10,9,23,3,1,49
Sidera vulgaris OMC 1730 v1.0,https://mycocosm.jgi.doe.gov/Sidvul1,0,0,1,10,4,1,11,27
Sirobasidium intermedium CBS7805 v1.0,https://mycocosm.jgi.doe.gov/Sirint1,0,0,0,4,0,1,0,5
Sistotrema muscicola OMC 1658 v1.0,https://mycocosm.jgi.doe.gov/Sismus1,0,0,1,3,1,0,0,5
Sistotrema raduloides OMC1660 v1.0,https://mycocosm.jgi.doe.gov/Sisrad1,0,0,1,5,2,0,0,8
Sistotrema sernanderi OMC 1753 v1.0,https://mycocosm.jgi.doe.gov/Sisser1,0,0,2,7,1,0,1,11
Sistotrema sp. PMI_390 v1.0,https://mycocosm.jgi.doe.gov/ClaPMI390,0,0,0,6,1,0,1,8
Sistotremastrum niveocremeum HHB9708 ss-1 1.0,https://mycocosm.jgi.doe.gov/Sisni1,0,0,1,6,1,0,12,20
Sistotremastrum suecicum v1.0,https://mycocosm.jgi.doe.gov/Sissu1,0,0,1,6,1,0,11,19
Slooffia pilatii Y-17178 v1.0,https://mycocosm.jgi.doe.gov/Slopil1,0,0,1,4,1,0,2,8
Smittium culicis GSMNP,https://mycocosm.jgi.doe.gov/SmicuMNP_2,0,0,0,1,2,1,0,4
Smittium culicis ID-206-W2,https://mycocosm.jgi.doe.gov/SmiculW2_1,0,0,0,1,2,1,0,4
Smittium mucronatum ALG-7-W6,https://mycocosm.jgi.doe.gov/Smimuc2,0,0,0,1,3,1,0,5
Sodiomyces alkalinus v1.0,https://mycocosm.jgi.doe.gov/Sodal1,1,3,3,5,10,2,0,24
Sordaria brevicollis FGSC1904 v1.0,https://mycocosm.jgi.doe.gov/Sorbr1,1,0,3,4,7,2,0,17
Sordaria humana MPI-SDFR-AT-0083 v1.0,https://mycocosm.jgi.doe.gov/Sorhu1,1,0,4,3,10,2,1,21
Sordaria macrospora k-hell,https://mycocosm.jgi.doe.gov/Sorma1,1,0,4,3,9,2,1,20
Sparassis latifolia CCMJ1100 v1.0,https://mycocosm.jgi.doe.gov/Spalat1,2,0,1,8,7,0,9,27
Spathaspora arborariae UFMG-HMD-19.1 v1.0,https://mycocosm.jgi.doe.gov/Spaarb1,0,0,0,1,0,2,0,3
Spathaspora passalidarum NRRL Y-27907 v2.0,https://mycocosm.jgi.doe.gov/Spapa3,0,0,0,1,0,2,0,3
Spathaspora suhii UFMG-HMD-16.2 v1.0,https://mycocosm.jgi.doe.gov/Spasuh1,0,0,0,1,0,2,0,3
Spathularia flavida,https://mycocosm.jgi.doe.gov/Spafl1,2,3,11,21,23,5,1,66
Sphaerobolus stellatus v1.0,https://mycocosm.jgi.doe.gov/Sphst1,3,0,2,23,12,7,31,78
Sphaerosporella brunnea Sb_GMNB300 v2.0,https://mycocosm.jgi.doe.gov/Sphbr2,1,1,3,3,1,2,3,14
Spinellus fusiger NRRL 22323 v1.0,https://mycocosm.jgi.doe.gov/Spifus1,0,0,0,6,1,1,0,8
Spizellomyces punctatus DAOM BR117,https://mycocosm.jgi.doe.gov/Spipu1,0,0,4,6,2,1,0,13
Sporidiobolus pararoseus UCDFST 68-350 v1.0,https://mycocosm.jgi.doe.gov/Spopa1,0,0,1,1,1,0,0,3
Sporisorium reilianum SRZ2,https://mycocosm.jgi.doe.gov/Spore1,0,0,2,5,1,1,0,9
Sporobolomyces gracilis NRRL Y-5504 v1.0,https://mycocosm.jgi.doe.gov/Spogra1_1,0,0,0,2,1,0,0,3
Sporobolomyces linderae CBS 7893 v1.0,https://mycocosm.jgi.doe.gov/Spoli1,0,0,1,3,1,0,0,5
Sporobolomyces roseus v1.0,https://mycocosm.jgi.doe.gov/Sporo1,0,0,1,1,0,1,0,3
Sporodiniella umbellata MES 1446 v1.0,https://mycocosm.jgi.doe.gov/Spoumb1,0,0,1,6,1,1,0,9
Sporopachydermia lactativora Phaff 68-199 v1.0,https://mycocosm.jgi.doe.gov/Spola1,0,0,0,1,0,2,0,3
Sporormia fimetaria v1.0,https://mycocosm.jgi.doe.gov/Spofi1,1,0,3,2,6,2,0,14
Sporothrix brasiliensis 5110,https://mycocosm.jgi.doe.gov/Spobr1,0,0,1,6,5,2,0,14
Sporothrix insectorum RCEF 264,https://mycocosm.jgi.doe.gov/Spoin1,0,1,3,7,5,2,0,18
Sporothrix schenckii 1099-18,https://mycocosm.jgi.doe.gov/Sposc1,0,0,2,6,6,2,0,16
Spraguea lophii 42 110,https://mycocosm.jgi.doe.gov/Sprlo1,,,,,,,,0
Stachybotrys chartarum IBT 40288,https://mycocosm.jgi.doe.gov/Stach1,3,3,4,7,29,3,5,54
Stachybotrys chlorohalonata IBT 40285,https://mycocosm.jgi.doe.gov/Stachl1,5,2,5,8,19,2,3,44
Stachybotrys elegans MPI-CAGE-CH-0235 v1.0,https://mycocosm.jgi.doe.gov/Stael1,6,4,8,14,31,2,7,72
Stagonospora nodorum SN15 v2.0,https://mycocosm.jgi.doe.gov/Stano2,2,1,9,6,13,1,2,34
Stagonospora sp. SRC1lsM3a v1.0,https://mycocosm.jgi.doe.gov/Stasp1,2,2,6,6,16,3,4,39
Stanjemonium grisellum CBS 655.79 v1.0,https://mycocosm.jgi.doe.gov/Stagr1,0,6,16,14,13,4,5,58
Starmerella bombicola SB1 v1.0,https://mycocosm.jgi.doe.gov/Stabo1,0,0,2,0,0,2,0,4
Starmerella floricola CF1 v2.0,https://mycocosm.jgi.doe.gov/Staflo2,0,0,2,0,0,2,0,4
Stemphylium lycopersici CIDEFI-216,https://mycocosm.jgi.doe.gov/Stely1,0,1,5,6,14,2,2,30
Stereum hirsutum FP-91666 SS1 v1.0,https://mycocosm.jgi.doe.gov/Stehi1,1,0,1,18,6,1,15,42
Stomiopeltis betulae CBS114420 v1.0,https://mycocosm.jgi.doe.gov/Stobe1,0,2,6,4,15,2,0,29
Sugiyamaella americana NRRL YB-2067 v1.0,https://mycocosm.jgi.doe.gov/Sugame1,0,0,0,1,0,2,0,3
Suillus americanus EM31 v1.0,https://mycocosm.jgi.doe.gov/Suiame1,0,0,1,9,3,0,22,35
Suillus ampliporus FC55 v1.0,https://mycocosm.jgi.doe.gov/Suiamp1,0,0,1,15,2,0,16,34
Suillus bovinus UH-Sbo-P2 v1.0,https://mycocosm.jgi.doe.gov/Suibov1,0,0,1,12,3,0,12,28
Suillus brevipes Sb2 v2.0,https://mycocosm.jgi.doe.gov/Suibr2,0,0,1,10,3,0,11,25
Suillus cf. sibiricus RUI384 v1.0,https://mycocosm.jgi.doe.gov/Suisib1,0,0,1,13,3,0,21,38
Suillus cf. subluteus FC464 v1.0,https://mycocosm.jgi.doe.gov/Suisubl1,0,0,1,18,3,0,29,51
Suillus cf. variegatus FC465 v1.0,https://mycocosm.jgi.doe.gov/Suivari1,0,0,1,15,4,0,18,38
Suillus clintonianus FC179 v1.0,https://mycocosm.jgi.doe.gov/Suicli1,0,0,1,18,8,0,16,43
Suillus collinitus S28 v1.0,https://mycocosm.jgi.doe.gov/Suicol1,0,0,1,11,4,1,10,27
Suillus cothurnatus VC 1858 v1.0,https://mycocosm.jgi.doe.gov/Suicot1,0,0,1,12,3,0,27,43
Suillus decipiens EM49 v1.0,https://mycocosm.jgi.doe.gov/Suidec1,0,0,1,15,3,0,12,31
Suillus discolor FC423 v1.0,https://mycocosm.jgi.doe.gov/Suidis1,0,0,1,19,3,0,20,43
Suillus elbensis FC64 v1.0,https://mycocosm.jgi.doe.gov/Suielb1,0,0,1,17,6,0,18,42
Suillus fuscotomentosus FC203 v1.0,https://mycocosm.jgi.doe.gov/Suifus1,0,0,1,15,3,0,23,42
Suillus grisellus FC184 v1.0,https://mycocosm.jgi.doe.gov/Suigri1,0,0,1,11,5,0,7,24
Suillus hirtellus EM16 v1.0,https://mycocosm.jgi.doe.gov/Suihi1,0,0,1,16,3,0,22,42
Suillus kaibabensis FC96 v2.0,https://mycocosm.jgi.doe.gov/Suikai2,0,0,1,11,3,0,9,24
Suillus lakei FC43 v1.0,https://mycocosm.jgi.doe.gov/Suilak1,0,0,1,16,4,0,21,42
Suillus luteus UH-Slu-Lm8-n1 v3.0,https://mycocosm.jgi.doe.gov/Suilu4,0,0,1,8,3,0,8,20
Suillus occidentalis FC124 v1.0,https://mycocosm.jgi.doe.gov/Suiocc1,0,0,1,8,3,0,10,22
Suillus ochraceoroseus FC498 v1.0,https://mycocosm.jgi.doe.gov/Suioch1,0,0,1,9,4,0,8,22
Suillus paluster FC165 v1.0,https://mycocosm.jgi.doe.gov/Suipal1,0,0,1,9,3,0,8,21
Suillus placidus DOB743 v1.0,https://mycocosm.jgi.doe.gov/Suipla1,0,0,1,11,5,0,15,32
Suillus placidus S07 v1.0,https://mycocosm.jgi.doe.gov/Suiplac1,0,0,1,11,5,0,17,34
Suillus plorans S12 v1.0,https://mycocosm.jgi.doe.gov/Suiplo1,0,0,1,15,3,0,16,35
Suillus pseudogranulatus FC45 v1.0,https://mycocosm.jgi.doe.gov/Suipse1,0,0,1,10,3,0,9,23
Suillus punctipes FC325 v1.0,https://mycocosm.jgi.doe.gov/Suipunc1,0,0,1,13,2,0,15,31
Suillus pungens FC27 v1.0,https://mycocosm.jgi.doe.gov/Suipun1,0,0,1,8,2,0,11,22
Suillus quiescens FC197 v1.0,https://mycocosm.jgi.doe.gov/Suiqui1,0,0,1,9,3,0,11,24
Suillus sp. nov. FC429 v1.0,https://mycocosm.jgi.doe.gov/SuiFC429_1,0,0,1,13,3,0,15,32
Suillus spraguei EM44 v1.0,https://mycocosm.jgi.doe.gov/Suipic1,0,0,1,18,3,0,11,33
Suillus subalutaceus 1-7C v1.0,https://mycocosm.jgi.doe.gov/Suisuba1,0,0,1,8,2,0,9,20
Suillus subalutaceus FC151 v1.0,https://mycocosm.jgi.doe.gov/Suisu1,0,0,1,16,3,0,30,50
Suillus subaureus MN1 v1.0,https://mycocosm.jgi.doe.gov/Suisub1,0,0,1,15,2,1,16,35
Suillus tomentosus FC115 v1.0,https://mycocosm.jgi.doe.gov/Suitom1,0,0,1,16,3,0,23,43
Suillus variegatus UH-Sva-Z1 v1.0,https://mycocosm.jgi.doe.gov/Suivar1,0,0,1,15,2,0,24,42
Suillus viscidus S02 v2.0,https://mycocosm.jgi.doe.gov/Suivis2,0,0,1,23,6,0,20,50
Suillus weaverae EM37 v1.0,https://mycocosm.jgi.doe.gov/Suigr1,0,0,1,10,4,0,17,32
Symbiotaphrina kochii v1.0,https://mycocosm.jgi.doe.gov/Symko1,0,0,3,9,7,2,2,23
Sympodiomyces attinorum NRRL Y-27639 v1.0,https://mycocosm.jgi.doe.gov/Symat1,0,0,0,2,0,2,0,4
Syncephalastrum racemosum NRRL 2496 v1.0,https://mycocosm.jgi.doe.gov/Synrac1,0,0,0,7,1,1,0,9
Syncephalis fuscata S228 v1.0,https://mycocosm.jgi.doe.gov/Synfus1,0,0,1,0,0,1,0,2
Syncephalis plumigaleata NRRL S24 v1.0,https://mycocosm.jgi.doe.gov/Synplu1,0,0,1,0,0,1,0,2
Syncephalis pseudoplumigaleata Benny S71-1 single-cell v1.0,https://mycocosm.jgi.doe.gov/Synps1,0,0,1,0,0,1,0,2
Talaromyces aculeatus ATCC 10409 v1.0,https://mycocosm.jgi.doe.gov/Penac1,0,2,11,17,26,5,1,62
Talaromyces atroroseus IBT 11181,https://mycocosm.jgi.doe.gov/Talat1,0,5,10,15,15,4,1,50
Talaromyces borbonicus CBS 141340,https://mycocosm.jgi.doe.gov/Talabor1,2,3,8,8,16,2,2,41
Talaromyces islandicus WF3812,https://mycocosm.jgi.doe.gov/Talis1,1,3,14,14,23,3,3,61
Talaromyces marneffei ATCC 18224,https://mycocosm.jgi.doe.gov/Talma1_2,1,2,8,13,18,5,2,49
Talaromyces proteolyticus PMI_201 v1.0,https://mycocosm.jgi.doe.gov/Talpro1,4,2,8,13,40,3,1,71
Talaromyces stipitatus ATCC 10500,https://mycocosm.jgi.doe.gov/Talst1_2,1,3,6,15,29,6,4,64
Taphrina deformans,https://mycocosm.jgi.doe.gov/Tapde1_1,0,0,0,3,0,1,0,4
Taphrina populi-salicis CBS419.54 v1.0,https://mycocosm.jgi.doe.gov/Tappo1,0,0,1,3,0,2,0,6
Teichospora sp. FL1471 v1.0,https://mycocosm.jgi.doe.gov/Currey1,1,1,4,11,17,3,4,41
Teratosphaeria nubilosa CBS 116005 v1.0,https://mycocosm.jgi.doe.gov/Ternu1,0,2,4,9,6,2,1,24
Teratosphaeriaceae sp. NC1134 v1.0,https://mycocosm.jgi.doe.gov/TerNC1134_1,0,0,5,8,1,2,1,17
Terfezia boudieri ATCC MYA-4762 v1.1,https://mycocosm.jgi.doe.gov/Terbo2,0,0,1,1,3,2,0,7
Terfezia claveryi T7 v1.0,https://mycocosm.jgi.doe.gov/Tercla1,0,0,1,1,3,2,0,7
Termitomyces sp. J132,https://mycocosm.jgi.doe.gov/TerJ132_1,0,0,1,16,2,1,23,43
Testicularia cyperi MCA 3645 v1.0,https://mycocosm.jgi.doe.gov/Tescy1,0,0,1,5,2,1,0,9
Tetrapisispora blattae CBS 6284,https://mycocosm.jgi.doe.gov/Tetbla1,0,0,0,1,0,2,0,3
Tetrapisispora phaffii CBS 4417,https://mycocosm.jgi.doe.gov/Tetpha1,0,0,0,1,0,2,0,3
Thamnidium elegans v1.0,https://mycocosm.jgi.doe.gov/Thaele1,0,0,1,4,1,1,0,7
Thamnocephalis sphaerospora RSA 1356 single-cell v1.0,https://mycocosm.jgi.doe.gov/Thasp1,0,0,0,1,0,1,0,2
Thanatephorus cucumeris MPI-SDFR-AT-0096 v1.0,https://mycocosm.jgi.doe.gov/Thacu1,0,0,1,6,1,0,7,15
Thelebolus globosus UNIPAMPA015 v1.0,https://mycocosm.jgi.doe.gov/Theglo1,0,0,2,2,1,2,0,7
Thelebolus microsporus ATCC 90970 v1.0,https://mycocosm.jgi.doe.gov/Themi1,0,0,1,2,1,2,0,6
Thelebolus stercoreus,https://mycocosm.jgi.doe.gov/Thest1,0,0,3,2,2,2,0,9
Thelephora ganbajun P2 v1.0,https://mycocosm.jgi.doe.gov/Thega1,1,1,2,6,5,0,7,22
Thelephora terrestris UH-Tt-Lm1 v1.0,https://mycocosm.jgi.doe.gov/Theter1,1,2,2,6,3,0,8,22
Thermoascus aurantiacus ATCC26904 v2.0,https://mycocosm.jgi.doe.gov/Theau2,0,1,3,3,3,2,0,12
Thermomyces lanuginosus SSBP,https://mycocosm.jgi.doe.gov/Thelan1,1,1,3,3,4,2,0,14
Thielavia antarctica CBS 123565 v1.0,https://mycocosm.jgi.doe.gov/Thian1,0,1,4,2,4,2,1,14
Thielavia appendiculata CBS 731.68 v1.0,https://mycocosm.jgi.doe.gov/Thiap1,0,0,5,4,12,3,2,26
Thielavia arenaria CBS 508.74 v1.0,https://mycocosm.jgi.doe.gov/Thiar1,0,3,4,4,22,2,3,38
Thielavia hyrcaniae CBS 757.83 v1.0,https://mycocosm.jgi.doe.gov/Thihy1,1,1,5,3,7,2,2,21
Thielavia terrestris v2.0,https://mycocosm.jgi.doe.gov/Thite2,0,1,3,2,13,2,1,22
Thielaviopsis punctulata CR-DP1,https://mycocosm.jgi.doe.gov/Thipu1,0,0,1,2,3,2,0,8
Thozetella sp. PMI_491 v2.0,https://mycocosm.jgi.doe.gov/ThoPMI491_1,3,5,18,19,36,5,6,92
Tilletia caries DAOM 238032,https://mycocosm.jgi.doe.gov/Tilcar1,1,0,1,6,1,1,0,10
Tilletia controversa DAOM 236426,https://mycocosm.jgi.doe.gov/Tilco1,1,0,1,6,0,1,0,9
Tilletia indica DAOM 236416,https://mycocosm.jgi.doe.gov/Tilin1,1,1,3,7,0,1,0,13
Tilletia walkeri DAOM 236422,https://mycocosm.jgi.doe.gov/Tilwal1,1,2,4,8,1,0,0,16
Tilletiaria anomala UBC 951 v1.0,https://mycocosm.jgi.doe.gov/Tilan2,0,0,2,3,1,2,0,8
Tilletiopsis albescens v1.0,https://mycocosm.jgi.doe.gov/Tilalb1,1,0,1,6,3,1,0,12
Tilletiopsis sp. TKC30 v1.0,https://mycocosm.jgi.doe.gov/Tillet1,1,0,1,4,1,0,0,7
Tilletiopsis washingtonensis MCA 4186 v1.0,https://mycocosm.jgi.doe.gov/Tilwa1,1,0,2,6,1,1,0,11
Tirmania nivea G3 v1.0,https://mycocosm.jgi.doe.gov/Tirniv1,0,0,1,2,3,2,0,8
Tolypocladium capitatum CBS 113982,https://mycocosm.jgi.doe.gov/Tolca1,1,3,8,3,14,3,1,33
Tolypocladium inflatum NRRL 8044,https://mycocosm.jgi.doe.gov/Tolinf1,1,3,12,9,16,3,0,44
Tolypocladium ophioglossoides CBS100239,https://mycocosm.jgi.doe.gov/Tolop1,0,2,9,7,13,3,1,35
Tolypocladium paradoxum NRBC 100945,https://mycocosm.jgi.doe.gov/Tolpa1,2,1,9,6,10,3,1,32
Torpedospora radiata JK5252C v1.0,https://mycocosm.jgi.doe.gov/Torra1,0,0,2,3,7,2,0,14
Torrubiella hemipterigena BCC1449,https://mycocosm.jgi.doe.gov/Torhe1,0,3,11,4,11,3,2,34
Tortispora caseinolytica Y-17796 v1.0,https://mycocosm.jgi.doe.gov/Canca1,0,0,1,1,0,2,1,5
Torulaspora delbrueckii CBS 1146,https://mycocosm.jgi.doe.gov/Torde1,0,0,0,1,0,3,0,4
Tothia fuscella CBS 130266 v1.0,https://mycocosm.jgi.doe.gov/Totfu1,0,2,4,5,5,1,0,17
Trachipleistophora hominis,https://mycocosm.jgi.doe.gov/Traho1,,,,,,,,0
Trametes betulina CIRM-BRFM 1801 v1.0,https://mycocosm.jgi.doe.gov/Trabet1,0,0,1,8,2,0,10,21
Trametes cingulata BRFM 1805 v1.0,https://mycocosm.jgi.doe.gov/Traci1,0,0,1,8,4,0,7,20
Trametes gibbosa CIRM-BRFM 1770 v1.0,https://mycocosm.jgi.doe.gov/Tragib1,0,0,1,9,2,0,10,22
Trametes ljubarskyi CIRM1659 v1.0,https://mycocosm.jgi.doe.gov/Tralj1,0,0,1,7,4,0,8,20
Trametes maxima CIRM-BRFM 1813 v1.0,https://mycocosm.jgi.doe.gov/Tramax1,0,0,3,8,2,0,9,22
Trametes meyenii CIRM-BRFM 1810 v1.0,https://mycocosm.jgi.doe.gov/Tramey1,0,0,1,9,2,0,11,23
Trametes polyzona CIRM-BRFM 1798 v1.0,https://mycocosm.jgi.doe.gov/Trapol1,0,0,1,7,3,0,9,20
Trametes pubescens FBCC735,https://mycocosm.jgi.doe.gov/Trapub1,0,0,2,8,2,0,10,22
Trametes versicolor v1.0,https://mycocosm.jgi.doe.gov/Trave1,0,0,2,8,3,0,10,23
Trametopsis cervina CIRM-BRFM 1824 v1.0,https://mycocosm.jgi.doe.gov/Trace1,0,0,0,8,2,0,4,14
Trematosphaeria pertusa CBS 122368 v1.0,https://mycocosm.jgi.doe.gov/Trepe1,2,0,6,9,18,3,2,40
Tremella mesenterica Fries v1.0,https://mycocosm.jgi.doe.gov/Treme1,0,0,0,1,0,1,0,2
Trichaptum abietinum v1.0,https://mycocosm.jgi.doe.gov/Triab1_1,0,0,1,17,5,0,11,34
Tricharina aff. praecox DOB1048 v1.0,https://mycocosm.jgi.doe.gov/Pezsub1,0,0,2,3,0,2,0,7
Tricharina praecox DOB2270 v1.0,https://mycocosm.jgi.doe.gov/Tripra1,0,0,2,3,0,2,0,7
Trichocoma paradoxa CBS 103.73 v1.0,https://mycocosm.jgi.doe.gov/Tripara1,3,6,15,7,11,5,1,48
Trichodelitschia bisporula CBS 262.69 v1.0,https://mycocosm.jgi.doe.gov/Tribi1,0,0,2,1,1,2,0,6
Trichoderma arundinaceum IBT 40837,https://mycocosm.jgi.doe.gov/Triaru1,0,4,13,9,22,3,4,55
Trichoderma asperelloides TR356 v1.0,https://mycocosm.jgi.doe.gov/Triasp1,0,3,11,12,12,3,5,46
Trichoderma asperellum CBS 433.97 v1.0,https://mycocosm.jgi.doe.gov/Trias1,0,2,13,11,12,2,4,44
Trichoderma atrobrunneum ITEM 908,https://mycocosm.jgi.doe.gov/Triatrob1,0,2,4,7,17,2,4,36
Trichoderma atroviride B10 v1.0,https://mycocosm.jgi.doe.gov/Triatr1,0,2,9,10,12,2,4,39
Trichoderma atroviride F7 v1.0,https://mycocosm.jgi.doe.gov/Triatro1,0,0,9,12,14,2,3,40
Trichoderma atroviride P1 v1.0,https://mycocosm.jgi.doe.gov/Triatrov1,0,2,8,11,13,2,4,40
Trichoderma atroviride v2.0,https://mycocosm.jgi.doe.gov/Triat2,0,2,9,10,13,2,3,39
Trichoderma brevicompactum IBT40841,https://mycocosm.jgi.doe.gov/Tribre1,1,3,18,9,27,3,6,67
Trichoderma citrinoviride TUCIM 6016 v4.0,https://mycocosm.jgi.doe.gov/Trici4,0,2,8,7,10,2,4,33
Trichoderma gamsii T6085,https://mycocosm.jgi.doe.gov/Trigam1,0,1,10,11,13,2,2,39
Trichoderma guizhouense NJAU 4742,https://mycocosm.jgi.doe.gov/Trigui1,0,6,12,8,20,2,6,54
Trichoderma hamatum GD12,https://mycocosm.jgi.doe.gov/Triham1,0,2,13,11,15,2,3,46
Trichoderma harzianum CBS 226.95 v1.0,https://mycocosm.jgi.doe.gov/Triha1,0,5,13,10,21,2,6,57
Trichoderma harzianum M10 v1.0,https://mycocosm.jgi.doe.gov/TriharM10_1,1,6,15,10,20,3,6,61
Trichoderma harzianum T22 v1.0,https://mycocosm.jgi.doe.gov/TriharT22_1,0,6,15,10,19,3,6,59
Trichoderma harzianum TR274 v1.0,https://mycocosm.jgi.doe.gov/Trihar1,0,5,14,9,20,2,6,56
Trichoderma longibrachiatum ATCC 18648 v3.0,https://mycocosm.jgi.doe.gov/Trilo3,0,1,7,5,9,3,3,28
Trichoderma longibrachiatum MK1 v1.0,https://mycocosm.jgi.doe.gov/Trilon1,0,1,7,5,9,2,3,27
Trichoderma parareesei CBS 125925,https://mycocosm.jgi.doe.gov/Tripar1,0,1,7,6,10,2,4,30
Trichoderma pleuroti TPhu1,https://mycocosm.jgi.doe.gov/Triple1,0,4,13,11,21,3,8,60
Trichoderma reesei CBS999.97 MAT1-1,https://mycocosm.jgi.doe.gov/TrireMAT11_1,0,1,8,6,9,2,4,30
Trichoderma reesei CBS999.97 MAT1-2,https://mycocosm.jgi.doe.gov/TrireMAT12_1,0,1,7,7,8,2,4,29
Trichoderma reesei QM6a,https://mycocosm.jgi.doe.gov/Trire_Chr,0,1,8,5,10,2,4,30
Trichoderma reesei RUT C-30 v1.0,https://mycocosm.jgi.doe.gov/TrireRUTC30_1,0,2,8,5,8,2,4,29
Trichoderma reesei v2.0,https://mycocosm.jgi.doe.gov/Trire2,0,2,8,5,9,2,4,30
Trichoderma virens Gv29-8 v2.0,https://mycocosm.jgi.doe.gov/TriviGv29_8_2,0,2,18,13,17,2,6,58
Tricholoma matsutake 945 v3.0,https://mycocosm.jgi.doe.gov/Trima3,0,0,0,10,2,0,7,19
Tricholoma populinum 2016PMI031 v1.0,https://mycocosm.jgi.doe.gov/Tripop1,0,0,0,11,2,0,11,24
Trichomonascus petasosporus NRRL YB-2093 v1.0,https://mycocosm.jgi.doe.gov/Tripe1,0,0,0,1,0,2,0,3
Trichophaea hybrida UTF0779 v1.0,https://mycocosm.jgi.doe.gov/Trihyb1,1,1,1,3,0,2,1,9
Trichophyton equinum CBS 127.97,https://mycocosm.jgi.doe.gov/Trieq1,3,3,12,3,8,3,2,34
Trichophyton interdigitale MR816,https://mycocosm.jgi.doe.gov/Triin1,2,2,13,7,9,2,2,37
Trichophyton mentagrophytes TIMM 2789,https://mycocosm.jgi.doe.gov/Trime1,2,2,13,5,9,2,2,35
Trichophyton rubrum CBS 118892,https://mycocosm.jgi.doe.gov/Triru1,1,3,13,2,8,2,2,31
Trichophyton soudanense CBS 452.61,https://mycocosm.jgi.doe.gov/Triso1,1,3,10,3,7,3,2,29
Trichophyton tonsurans CBS 112818,https://mycocosm.jgi.doe.gov/Trito1,2,3,12,4,8,3,2,34
Trichophyton verrucosum HKI 0517,https://mycocosm.jgi.doe.gov/Triver1,3,3,12,5,7,2,2,34
Trichophyton violaceum CMCC(F)T3l,https://mycocosm.jgi.doe.gov/Trivi1,3,3,9,4,5,1,2,27
Trichosporon asahii var. asahii CBS 2479,https://mycocosm.jgi.doe.gov/Trias2479,0,0,0,2,0,1,0,3
Trichosporon asahii var. asahii CBS 8904,https://mycocosm.jgi.doe.gov/Trias8904,0,0,0,3,0,1,0,4
Trichosporon chiarellii MYA-4694 v1.0,https://mycocosm.jgi.doe.gov/Trich1,0,0,0,2,0,1,0,3
Trichosporon guehoae v1.0,https://mycocosm.jgi.doe.gov/Trigue1,0,0,0,4,0,1,0,5
Trichosporon oleaginosus IBC0246 v1.0,https://mycocosm.jgi.doe.gov/Triol1,0,0,0,1,0,1,0,2
Trinosporium guianense CBS132537 v1.0,https://mycocosm.jgi.doe.gov/Trigu1,0,0,5,4,7,2,1,19
Triparticalcar arcticum BR59 v1.0,https://mycocosm.jgi.doe.gov/Triarc1,0,0,3,1,2,1,0,7
Tritirachium sp. CBS 265.96 v1.0,https://mycocosm.jgi.doe.gov/Trisp1,0,0,2,1,3,1,0,7
Truncatella angustata MPI-SDFR-AT-0073 v1.0,https://mycocosm.jgi.doe.gov/Truan1,2,2,17,13,38,4,9,85
Tuber aestivum var. urcinatum v1.0,https://mycocosm.jgi.doe.gov/Tubae1,0,0,1,5,1,3,0,10
Tuber borchii Tbo3840 v1.0,https://mycocosm.jgi.doe.gov/Tubbor1,0,0,1,3,1,2,0,7
Tuber brumale v1.0,https://mycocosm.jgi.doe.gov/Tubbr1_1,0,0,1,3,1,2,0,7
Tuber canaliculatum GB_Tcana1 v1.0,https://mycocosm.jgi.doe.gov/Tubcan1,0,0,1,3,1,2,0,7
Tuber gibbosum GB_Tgibb2 v1.0,https://mycocosm.jgi.doe.gov/Tubgib1,0,0,1,2,2,2,0,7
Tuber indicum v1.0,https://mycocosm.jgi.doe.gov/Tubin1_1,0,0,1,4,1,2,0,8
Tuber magnatum v1.0,https://mycocosm.jgi.doe.gov/Tubma1,0,0,1,4,2,2,0,9
Tuber melanosporum Mel28 v1.2,https://mycocosm.jgi.doe.gov/Tubme1v2,0,0,1,3,2,2,0,8
Tuber melosporum Tmelo v1.0,https://mycocosm.jgi.doe.gov/Tubmel1,0,0,1,3,2,2,0,8
Tuber mesentericum Tmes4 v1.0,https://mycocosm.jgi.doe.gov/Tubmes1,0,0,1,4,2,2,0,9
Tulasnella calospora AL13/4D v1.0,https://mycocosm.jgi.doe.gov/Tulca1,0,0,0,2,1,0,7,10
Tulasnella calospora UAMH 9824 v1.0,https://mycocosm.jgi.doe.gov/Tulcal1,0,0,0,2,1,0,5,8
Tulasnella inquilina UAMH 7632 v1.0,https://mycocosm.jgi.doe.gov/Tulinq1,0,0,0,9,1,0,7,17
Tulasnella sp. 425 v1.0,https://mycocosm.jgi.doe.gov/Tulsp425_1,0,0,0,2,1,0,10,13
Typhula sp. TRa3160C v1.0,https://mycocosm.jgi.doe.gov/TyphTRa3160C_1,0,1,1,10,3,0,4,19
Umbelopsis angularis P8C34 v1.0,https://mycocosm.jgi.doe.gov/Umban1,0,0,1,4,1,1,0,7
Umbelopsis isabellina AD026 v1.0,https://mycocosm.jgi.doe.gov/Umbisa1,0,0,1,5,1,2,0,9
Umbelopsis ramanniana AG # v1.0,https://mycocosm.jgi.doe.gov/Umbra1,0,0,1,4,0,1,0,6
Umbelopsis sp. PMI_123 v1.0,https://mycocosm.jgi.doe.gov/Umbelo1,0,0,1,4,1,1,0,7
Umbelopsis sp. nov. AD052 v1.0,https://mycocosm.jgi.doe.gov/Umbsp_AD052_1,0,0,1,3,1,1,0,6
Umbilicaria pustulata,https://mycocosm.jgi.doe.gov/Umbpus1,0,1,0,3,16,0,1,21
Uncinocarpus reesii UAMH 1704,https://mycocosm.jgi.doe.gov/Uncre1,3,2,4,2,4,2,0,17
Unilacryma unispora MAFF 240146 v1.0,https://mycocosm.jgi.doe.gov/Uniuni1,1,0,0,10,2,0,4,17
Urocystis occulta CBS 102.71 v1.0,https://mycocosm.jgi.doe.gov/Uroocc1,1,0,2,6,0,2,0,11
Urocystis primulicola RUB 030670 v1.0,https://mycocosm.jgi.doe.gov/Uropr1,0,0,1,3,2,1,0,7
Usnea florida ATCC18376 v1.0,https://mycocosm.jgi.doe.gov/Usnflo1,3,3,7,19,47,5,3,87
Ustanciosporium gigantosporum RK316 v1.0,https://mycocosm.jgi.doe.gov/Ustgig1,0,0,2,6,2,1,0,11
Ustilaginoidea virens,https://mycocosm.jgi.doe.gov/Ustvir1,0,0,4,7,2,2,0,15
Ustilago bromivora UB2112,https://mycocosm.jgi.doe.gov/Ustbr1,0,0,2,5,2,0,0,9
Ustilago hordei Uh4857_4,https://mycocosm.jgi.doe.gov/Usthor1,0,0,2,5,1,1,0,9
Ustilago maydis 521 v2.0,https://mycocosm.jgi.doe.gov/Ustma2_2,2,0,3,7,3,1,0,16
Valetoniellopsis laxa CBS 191.97 v1.0,https://mycocosm.jgi.doe.gov/Valla1,0,0,5,7,7,3,0,22
Valsa mali str. 03-8,https://mycocosm.jgi.doe.gov/Valma1,0,2,10,11,28,2,2,55
Valsariales sp. FL0756 v1.0,https://mycocosm.jgi.doe.gov/DelFL0756_1,1,2,6,4,27,2,3,45
Vanderwaltozyma polyspora DSM 70294,https://mycocosm.jgi.doe.gov/Vanpo1,0,0,0,1,0,2,0,3
Vararia minispora EC-137 v1.0,https://mycocosm.jgi.doe.gov/Varmin1,0,0,0,10,2,1,6,19
Vavraia culicis subsp. floridensis,https://mycocosm.jgi.doe.gov/Vavcu1,,,,,,,,0
Veluticeps abietina OMC1657 v1.0,https://mycocosm.jgi.doe.gov/Velabi1,0,0,0,17,6,0,16,39
Venturia effusa,https://mycocosm.jgi.doe.gov/Veneff1,3,0,3,6,3,2,0,17
Venturia inaequalis,https://mycocosm.jgi.doe.gov/Venin1,2,0,4,9,6,2,0,23
Venturia pirina,https://mycocosm.jgi.doe.gov/Venpi1,2,1,3,9,8,2,1,26
Venturiales sp. P10P74 v1.0,https://mycocosm.jgi.doe.gov/VenspP74_1,1,1,2,8,6,2,1,21
Verpa conica TJ0815 v1.0,https://mycocosm.jgi.doe.gov/Vercon1,0,0,2,5,3,2,1,13
Verruconis gallopava,https://mycocosm.jgi.doe.gov/Verga1,0,0,2,3,5,2,0,12
Verruculina enalia CBS 304.66 v1.0,https://mycocosm.jgi.doe.gov/Veren1,1,4,10,6,26,3,0,50
Verticillium alfalfae VaMs.102,https://mycocosm.jgi.doe.gov/Veral1,0,0,5,9,8,2,0,24
Verticillium dahliae MPI-CAGE-AT-0001 v1.0,https://mycocosm.jgi.doe.gov/Verdah1,0,1,3,9,7,2,2,24
Verticillium dahliae VdLs.17,https://mycocosm.jgi.doe.gov/Verda1,0,1,3,9,6,3,1,23
Verticillium longisporum VL1,https://mycocosm.jgi.doe.gov/Verlo1,0,1,5,16,11,4,1,38
Violaceomyces palustris SA 807 v1.0,https://mycocosm.jgi.doe.gov/Ustsp1,1,2,2,4,5,1,0,15
Viridothelium virens v1.0,https://mycocosm.jgi.doe.gov/Tryvi1,5,1,3,10,33,2,7,61
Vittaforma corneae ATCC 50505,https://mycocosm.jgi.doe.gov/Vitco1,,,,,,,,0
Volvariella volvacea V23,https://mycocosm.jgi.doe.gov/Volvo1,0,0,1,9,3,0,7,20
Vuilleminia comedens VcCUCC2015_SSI3 v1.0,https://mycocosm.jgi.doe.gov/Vuico1,4,1,1,13,10,1,10,40
Vuilleminia comedens VcCUCC2015_SSI6 v1.0,https://mycocosm.jgi.doe.gov/Vuicom1,2,1,1,15,10,0,10,39
Wallemia ichthyophaga EXF-994,https://mycocosm.jgi.doe.gov/Walic1,0,0,1,3,1,0,0,5
Wallemia mellicola v1.0,https://mycocosm.jgi.doe.gov/Walse1,0,0,1,4,1,0,1,7
Westerdykella ornata CBS 379.55 v1.0,https://mycocosm.jgi.doe.gov/Wesor1,0,2,5,6,12,2,0,27
Whalleya microplaca YMJ1829 v1.0,https://mycocosm.jgi.doe.gov/Whamic1,5,5,5,21,41,4,6,87
Wickerhamiella domercqiae NRRL Y-6692 v1.0,https://mycocosm.jgi.doe.gov/Wicdo1,0,0,0,1,0,2,0,3
Wickerhamiella sorbophila DS02,https://mycocosm.jgi.doe.gov/Wicso1,0,0,1,0,0,2,0,3
Wickerhamomyces anomalus NRRL Y-366-8 v1.0,https://mycocosm.jgi.doe.gov/Wican1,0,0,0,1,0,2,0,3
Wilcoxina mikolae CBS 423.85 v1.0,https://mycocosm.jgi.doe.gov/Wilmi1,0,1,1,2,4,2,1,11
Wolfiporia cocos MD-104 SS10 v1.0,https://mycocosm.jgi.doe.gov/Wolco1,0,0,0,9,7,0,8,24
Xanthophyllomyces dendrorhous CBS 6938 v1.0,https://mycocosm.jgi.doe.gov/XandeCB38_1,0,0,1,2,1,0,0,4
Xanthophyllomyces dendrorhous UBV-AX4 v1.0,https://mycocosm.jgi.doe.gov/XandeAX4_1,0,0,1,2,1,0,0,4
Xanthoria parietina 46-1-SA22 v1.1,https://mycocosm.jgi.doe.gov/Xanpa2,0,2,6,13,21,2,6,50
Xenasmatella tulasnelloidea OMC1662 v1.0,https://mycocosm.jgi.doe.gov/Xentul1,0,0,1,8,6,0,5,20
Xenasmatella vaga CBS212.54 v1.0,https://mycocosm.jgi.doe.gov/Xenvag1,0,0,3,16,7,0,5,31
Xerocomus badius 84.06 v1.0,https://mycocosm.jgi.doe.gov/Xerba1,0,1,0,13,2,0,12,28
Xylaria acuta CBS 122032 v1.0,https://mycocosm.jgi.doe.gov/Xylacu1,4,2,7,13,36,3,11,76
Xylaria arbuscula CBS 124340 v1.0,https://mycocosm.jgi.doe.gov/Xylarb124340_1,2,5,7,18,42,6,9,89
Xylaria arbuscula FL1030 v1.0,https://mycocosm.jgi.doe.gov/XylarbFL1030,2,5,8,19,35,4,5,78
Xylaria bambusicola CBS 139988 v1.0,https://mycocosm.jgi.doe.gov/Xylbam139988_1,3,6,11,16,30,4,10,80
Xylaria berteri 95101511 v1.0,https://mycocosm.jgi.doe.gov/Xylber1,5,3,10,16,33,3,9,79
Xylaria cf. castorea CBS 124033 v1.0,https://mycocosm.jgi.doe.gov/Xylcas124033_1,5,0,10,20,29,4,7,75
Xylaria cf. heliscus FL0509 v2.0,https://mycocosm.jgi.doe.gov/Xylhel2,5,5,8,17,32,6,13,86
Xylaria cubensis CBS 116.85 v1.0,https://mycocosm.jgi.doe.gov/Xylcube1,8,2,9,15,43,3,11,91
Xylaria curta 92092022 v1.0,https://mycocosm.jgi.doe.gov/Xylcur1,3,5,7,14,44,4,13,90
Xylaria curta CBS 114988 v1.0,https://mycocosm.jgi.doe.gov/Xylcur114988_1,7,6,8,21,44,5,14,105
Xylaria digitata CBS 161.22 v1.0,https://mycocosm.jgi.doe.gov/Xyldig1,1,2,7,14,39,3,16,82
Xylaria flabelliformis NC1011 v1.0,https://mycocosm.jgi.doe.gov/Xylcub1,7,4,9,17,44,3,11,95
Xylaria grammica CBS 120713 v1.0,https://mycocosm.jgi.doe.gov/Xylgra1,2,7,9,25,36,6,12,97
Xylaria hypoxylon OSC100004 v1.0,https://mycocosm.jgi.doe.gov/Xylhyp1,2,6,7,14,43,4,8,84
Xylaria intraflava YMJ 725 v1.0,https://mycocosm.jgi.doe.gov/Xylint1,4,5,7,13,29,3,4,65
Xylaria longipes CBS 148.73 v1.0,https://mycocosm.jgi.doe.gov/Xyllon1,7,2,9,21,38,5,14,96
Xylaria nigripes YMJ 653 v1.0,https://mycocosm.jgi.doe.gov/Xylni1,2,2,5,9,11,3,4,36
Xylaria palmicola CBS 124036 v1.0,https://mycocosm.jgi.doe.gov/Xylpal124036_1,1,2,9,15,34,3,10,74
Xylaria scruposa CBS 123580 v1.0,https://mycocosm.jgi.doe.gov/Xylscr1,7,8,7,18,45,4,11,100
Xylaria sp. CBS 124048 v1.0,https://mycocosm.jgi.doe.gov/Xy124048_1,3,0,5,9,9,2,3,31
Xylaria sp. FL0043 v1.0,https://mycocosm.jgi.doe.gov/XylFL0043,2,4,7,18,32,3,8,74
Xylaria sp. FL0064 v1.0,https://mycocosm.jgi.doe.gov/XyFL0064_1,4,4,11,19,31,4,10,83
Xylaria sp. FL0933 v1.0,https://mycocosm.jgi.doe.gov/XylFL0933,4,5,6,21,31,3,8,78
Xylaria sp. FL1042 v1.0,https://mycocosm.jgi.doe.gov/XylFL1042,3,5,11,16,34,4,5,78
Xylaria sp. FL1777 v1.0,https://mycocosm.jgi.doe.gov/XyFL1777_1,0,3,6,12,30,3,10,64
Xylaria telfairii CBS 121673 v1.0,https://mycocosm.jgi.doe.gov/Xyltel121673_1,6,5,6,13,46,3,8,87
Xylaria venustula FL0490 v1.0,https://mycocosm.jgi.doe.gov/Xylven1,3,1,6,21,33,5,12,81
Xylariaceae sp. AK1471 v1.0,https://mycocosm.jgi.doe.gov/XyAK1471_1,8,7,14,14,41,6,14,104
Xylariaceae sp. FL0016 v1.0,https://mycocosm.jgi.doe.gov/XylFL0016,4,4,8,12,16,2,5,51
Xylariaceae sp. FL0255 v1.0,https://mycocosm.jgi.doe.gov/XylFL0255,4,1,6,20,32,5,9,77
Xylariaceae sp. FL0594 v1.0,https://mycocosm.jgi.doe.gov/XylFL0594,2,2,8,14,22,5,10,63
Xylariaceae sp. FL0662B v1.0,https://mycocosm.jgi.doe.gov/XylFL0662B,3,5,4,17,34,6,7,76
Xylariaceae sp. FL0804 v2.0,https://mycocosm.jgi.doe.gov/XyFL0804_2,1,2,5,15,29,5,1,58
Xylariaceae sp. FL0821 v1.0,https://mycocosm.jgi.doe.gov/XyFL0821_1,4,5,8,24,41,4,10,96
Xylariaceae sp. FL1019 v1.0,https://mycocosm.jgi.doe.gov/XylFL1019,4,2,6,16,23,4,11,66
Xylariaceae sp. FL1272 v2.0,https://mycocosm.jgi.doe.gov/XyFL1272_2,5,2,9,18,29,5,14,82
Xylariaceae sp. FL1651 v1.0,https://mycocosm.jgi.doe.gov/XylFL1651,3,4,10,17,46,7,10,97
Xylariales sp. AK1849 v1.0,https://mycocosm.jgi.doe.gov/Plecto1,1,1,15,9,23,4,3,56
Xylariales sp. PMI_506 v1.0,https://mycocosm.jgi.doe.gov/XylPMI506,2,3,19,14,27,3,7,75
Xylariomycetidae sp. FL0641 v1.0,https://mycocosm.jgi.doe.gov/XyFL0641_1,0,2,4,14,25,2,3,50
Xylariomycetidae sp. FL2044 v1.0,https://mycocosm.jgi.doe.gov/XylFL2044,0,8,5,17,29,9,5,73
Xylogone sp. PMI_703 v1.0,https://mycocosm.jgi.doe.gov/XylPMI703_1,0,4,15,14,30,3,2,68
Xylona heveae TC161 v1.0,https://mycocosm.jgi.doe.gov/Xylhe1,1,2,4,4,8,3,1,23
Yarrowia lipolytica (strain CLIB122),https://mycocosm.jgi.doe.gov/Yarli1,0,0,0,1,0,2,0,3
Yarrowia lipolytica CLIB89(W29),https://mycocosm.jgi.doe.gov/YarliW29_1,0,0,0,1,0,2,0,3
Yarrowia lipolytica FKP355 v1.0,https://mycocosm.jgi.doe.gov/Yarlip1,0,0,0,1,0,2,0,3
Yarrowia lipolytica PO1f v1.0,https://mycocosm.jgi.doe.gov/YarliW29,0,0,0,1,0,2,0,3
Yarrowia lipolytica PO1f v2.0,https://mycocosm.jgi.doe.gov/YarlipO1F2,0,0,0,1,0,2,0,3
Yarrowia lipolytica YB392 v1.0,https://mycocosm.jgi.doe.gov/YarliYB392,0,0,0,1,0,2,0,3
Yarrowia lipolytica YB419 v1.0,https://mycocosm.jgi.doe.gov/YarliYB419,0,0,0,1,0,2,0,3
Yarrowia lipolytica YB420 v1.0,https://mycocosm.jgi.doe.gov/YarliYB420,0,0,0,1,0,2,0,3
Yarrowia lipolytica YB566 v1.0,https://mycocosm.jgi.doe.gov/YarliYB566,0,0,0,1,0,2,0,3
Yarrowia lipolytica YB567 v1.0,https://mycocosm.jgi.doe.gov/YarliYB567,0,0,0,1,0,2,0,3
Yarrowia lipolytica YlCW001 v1.0,https://mycocosm.jgi.doe.gov/YarliYlCW001,0,0,0,1,0,2,0,3
Zalerion varium MPI-CAGE-AT-0135 v1.0,https://mycocosm.jgi.doe.gov/Zalva1,0,3,8,10,12,5,7,45
Zancudomyces culisetae COL-18-3,https://mycocosm.jgi.doe.gov/Zancul2,0,0,0,1,0,3,0,4
Zasmidium cellare ATCC 36951 v1.0,https://mycocosm.jgi.doe.gov/Zasce1,0,1,8,13,18,2,1,43
Zoophthora radicans ATCC 208865 v1.0,https://mycocosm.jgi.doe.gov/Zoorad1,0,0,1,4,1,1,1,8
Zopfia rhizophila v1.0,https://mycocosm.jgi.doe.gov/Zoprh1,2,5,9,10,32,3,0,61
Zychaea mexicana RSA 1403 v1.0,https://mycocosm.jgi.doe.gov/Zycmex1,0,0,0,3,1,1,0,5
Zygoascus hellenicus Y-7136 v1.0,https://mycocosm.jgi.doe.gov/Zyghe1_2,0,0,1,0,0,2,0,3
Zygosaccharomyces rouxii CBS732,https://mycocosm.jgi.doe.gov/Zygro1,0,0,0,1,0,2,0,3
Zymoseptoria ardabiliae STIR04_1.1.1,https://mycocosm.jgi.doe.gov/Zymar1,0,0,7,8,6,2,0,23
Zymoseptoria brevis Zb18110,https://mycocosm.jgi.doe.gov/Zymbr1,0,0,10,6,11,4,1,32
Zymoseptoria pseudotritici STIR04_2.2.1,https://mycocosm.jgi.doe.gov/Zymps1,0,0,8,9,10,2,0,29
